Rk,Player,Nation,Pos,Squad,Age,Born,90s,Tackles Tkl,Tackles TklW,Tackles Def 3rd,Tackles Mid 3rd,Tackles Att 3rd,Challenges Tkl,Challenges Att,Challenges Tkl%,Challenges Lost,Blocks Blocks,Blocks Sh,Blocks Pass,Int,Tkl+Int,Clr,Err
1,Antonio Adán,ESP,GK,Atlético Madrid,31,1987,1.0,0,0,0,0,0,0,0,,0,0,0,0,0,0,0,0
2,Aday,ESP,DF|MF,Girona,30,1987,7.2,9,8,2,5,2,6,7,85.7,1,1,0,1,7,16,17,1
3,Aritz Aduriz,ESP,FW,Athletic Club,37,1981,10.5,4,2,1,1,2,1,7,14.3,6,2,1,1,0,4,4,0
4,Luis Advíncula,PER,DF,Rayo Vallecano,28,1990,26.5,52,38,38,12,2,21,31,67.7,10,22,2,20,19,71,60,1
5,Martin Agirregabiria,ESP,DF,Alavés,22,1996,22.6,45,29,32,10,3,28,46,60.9,18,33,11,22,27,72,65,1
6,Juan Aguilera,ESP,MF,Huesca,32,1985,3.8,2,2,0,1,1,1,4,25.0,3,4,2,2,4,6,2,0
7,Carlos Akapo,EQG,DF,Huesca,25,1993,11.4,28,15,18,8,2,19,33,57.6,14,12,2,10,23,51,36,0
8,Sergio Akieme,ESP,DF,Rayo Vallecano,20,1997,2.0,3,3,3,0,0,2,2,100.0,0,0,0,0,1,4,5,0
9,Jordi Alba,ESP,DF,Barcelona,29,1989,33.2,42,22,20,15,7,20,48,41.7,28,24,6,18,60,102,76,1
10,Pedro Alcalá,ESP,DF,Girona,29,1989,20.8,32,23,23,9,0,15,23,65.2,8,21,18,3,36,68,120,0
11,Rubén Alcaraz,ESP,MF,Valladolid,27,1991,33.1,96,54,50,40,6,32,89,36.0,57,59,10,49,38,134,52,1
12,Álex Alegría,ESP,FW|MF,Rayo Vallecano,25,1992,1.6,1,1,0,1,0,0,3,0.0,3,1,0,1,0,1,0,0
13,Iván Alejo,ESP,MF,Getafe,23,1995,1.6,2,0,0,2,0,0,4,0.0,4,2,0,2,0,2,3,0
14,Carles Aleñá,ESP,MF,Barcelona,20,1998,7.1,7,4,0,6,1,2,8,25.0,6,4,0,4,2,9,0,0
15,Alexander,ARG,FW,Leganés,29,1988,0.1,1,0,1,0,0,1,1,100.0,0,0,0,0,0,1,0,0
16,Júnior Alonso,PAR,DF|MF,Celta Vigo,25,1993,6.0,13,9,8,4,1,7,12,58.3,5,8,3,5,5,18,24,1
17,Sergio Álvarez,ESP,DF|MF,Eibar,26,1992,11.9,34,25,12,20,2,13,23,56.5,10,9,4,5,17,51,43,0
18,Sergio Álvarez,ESP,GK,Celta Vigo,31,1986,13.0,0,0,0,0,0,0,0,,0,0,0,0,0,0,4,0
19,Yeray Álvarez,ESP,DF,Athletic Club,23,1995,29.0,55,30,39,14,2,19,33,57.6,14,35,16,19,63,118,149,1
20,Ibrahim Amadou,FRA,MF|DF,Sevilla,25,1993,8.5,27,20,9,15,3,2,9,22.2,7,7,4,3,11,38,24,0
21,Jordi Amat,IDN,DF,Rayo Vallecano,26,1992,30.7,54,31,34,19,1,24,42,57.1,18,31,10,21,43,97,133,1
22,Amath,SEN,MF,Getafe,22,1996,11.1,20,13,7,11,2,6,27,22.2,21,17,0,17,10,30,12,0
23,José Ángel,ESP,DF,Eibar,28,1989,33.6,66,46,36,23,7,31,56,55.4,25,24,5,19,41,107,113,1
24,Miguel Ángel Moyá,ESP,GK,Real Sociedad,34,1984,11.0,1,1,1,0,0,1,2,50.0,1,0,0,0,1,2,9,2
25,Antoñito,ESP,DF|MF,Valladolid,30,1987,20.7,35,21,16,15,4,18,42,42.9,24,21,8,13,18,53,31,0
26,Vitorino Antunes,POR,DF|MF,Getafe,31,1987,24.2,41,26,22,17,2,27,45,60.0,18,33,7,26,43,84,75,1
27,Anuar,MAR,MF|FW,Valladolid,23,1995,12.0,33,19,15,16,2,6,14,42.9,8,14,1,13,11,44,25,1
28,Emmanuel Apeh,NGA,FW|MF,Celta Vigo,21,1996,0.2,0,0,0,0,0,0,1,0.0,1,0,0,0,0,0,0,0
29,Mauro Arambarri,URU,MF,Getafe,22,1995,29.7,59,33,18,37,4,23,76,30.3,53,44,9,35,30,89,36,0
30,Guilherme Arana,BRA,DF,Sevilla,21,1997,7.0,11,6,5,5,1,6,7,85.7,1,6,3,3,9,20,8,0
31,Néstor Araujo,MEX,DF,Celta Vigo,26,1991,29.8,42,22,32,9,1,18,22,81.8,4,32,21,11,35,77,153,1
32,Anaitz Arbilla,ESP,DF,Eibar,31,1987,21.7,31,24,25,5,1,17,27,63.0,10,12,5,7,46,77,92,2
33,Santiago Arias,COL,DF,Atlético Madrid,26,1992,19.7,48,32,31,16,1,20,31,64.5,11,14,2,12,34,82,43,0
34,José Arnaiz,ESP,MF|FW,Leganés,23,1995,1.3,1,1,1,0,0,0,3,0.0,3,0,0,0,2,3,1,0
35,Sergio Asenjo,ESP,GK,Villarreal,29,1989,32.0,0,0,0,0,0,0,1,0.0,1,0,0,0,3,3,26,2
36,Marco Asensio,ESP,FW,Real Madrid,22,1996,19.8,12,8,3,5,4,2,24,8.3,22,16,1,15,14,26,7,0
37,Iago Aspas,ESP,FW|MF,Celta Vigo,30,1987,25.0,16,11,4,8,4,4,20,20.0,16,14,0,14,16,32,5,0
38,Ezequiel Ávila,ARG,FW|MF,Huesca,24,1994,22.2,18,10,7,7,4,4,26,15.4,22,21,2,19,13,31,22,0
39,Abdoulaye Ba,SEN,DF,Rayo Vallecano,27,1991,23.4,46,33,37,8,1,29,39,74.4,10,32,18,14,29,75,165,4
40,Carlos Bacca,COL,FW,Villarreal,31,1986,14.1,4,2,1,2,1,0,5,0.0,5,4,0,4,8,12,5,0
41,Gareth Bale,WAL,FW,Real Madrid,29,1989,19.8,16,8,5,7,4,6,20,30.0,14,19,3,16,11,27,13,0
42,Mikel Balenziaga,ESP,DF,Athletic Club,30,1988,5.8,10,6,7,1,2,5,8,62.5,3,6,2,4,2,12,21,0
43,Éver Banega,ARG,MF,Sevilla,30,1988,29.6,71,50,32,35,4,20,70,28.6,50,26,5,21,28,99,28,0
44,Léo Baptistão,BRA,FW|MF,Espanyol,25,1992,13.7,22,14,11,5,6,8,27,29.6,19,17,0,17,8,30,14,0
45,Enis Bardhi,MKD,MF,Levante,23,1995,31.5,70,43,30,34,6,28,87,32.2,59,35,3,32,31,101,36,1
46,Antonio Barragán,ESP,DF|FW,Betis,31,1987,10.4,14,8,9,4,1,2,12,16.7,10,15,4,11,5,19,30,2
47,Ander Barrenetxea,ESP,FW|MF,Real Sociedad,16,2001,4.4,7,2,2,0,5,2,8,25.0,6,8,0,8,4,11,1,0
48,Marc Bartra,ESP,DF,Betis,27,1991,32.5,86,55,55,26,5,41,76,53.9,35,46,21,25,60,146,132,2
49,Borja Bastón,ESP,FW,Alavés,25,1992,16.0,16,7,4,9,3,2,24,8.3,22,16,5,11,4,20,10,0
50,Michy Batshuayi,BEL,FW,Valencia,24,1993,5.9,1,1,0,1,0,0,3,0.0,3,5,2,3,0,1,3,0
51,Jon Bautista,ESP,FW,Real Sociedad,23,1995,6.6,5,3,0,3,2,0,3,0.0,3,8,1,7,5,10,4,0
52,Bebé,CPV,FW|MF,Rayo Vallecano,28,1990,14.5,19,9,10,4,5,9,19,47.4,10,16,1,15,9,28,16,1
53,Bebé,CPV,MF,Eibar,28,1990,0.7,0,0,0,0,0,0,0,,0,1,0,1,1,1,0,0
54,Fran Beltrán,ESP,MF,Celta Vigo,19,1999,16.9,23,17,8,12,3,13,31,41.9,18,19,2,17,19,42,15,1
55,Wissam Ben Yedder,FRA,FW,Sevilla,27,1990,31.2,18,16,3,11,4,2,12,16.7,10,18,0,18,11,29,2,0
56,Karim Benzema,FRA,FW,Real Madrid,30,1987,32.8,24,11,2,11,11,2,17,11.8,15,16,1,15,8,32,25,0
57,Yuri Berchiche,ESP,DF|FW,Athletic Club,28,1990,34.7,46,31,26,11,9,23,46,50.0,23,34,9,25,42,88,82,0
58,Markel Bergara,ESP,MF,Getafe,32,1986,0.6,2,2,0,1,1,2,3,66.7,1,3,0,3,1,3,2,0
59,Pedro Bigas,ESP,DF,Eibar,27,1990,6.5,4,3,2,0,2,1,5,20.0,4,6,2,4,8,12,22,0
60,Alejandro Blanco,ESP,FW|MF,Alavés,19,1998,0.2,1,1,1,0,0,1,3,33.3,2,1,0,1,0,1,0,0
61,Rubén Blanco,ESP,GK,Celta Vigo,23,1995,25.0,1,0,1,0,0,1,2,50.0,1,1,0,1,2,3,13,2
62,Pablo de Blasis,ARG,DF|MF,Eibar,30,1988,16.9,32,19,17,8,7,12,32,37.5,20,18,0,18,13,45,20,0
63,Emmanuel Boateng,GHA,FW,Levante,22,1996,7.8,4,3,0,0,4,0,3,0.0,3,5,0,5,1,5,7,0
64,Kevin-Prince Boateng,GHA,FW,Barcelona,31,1987,2.7,3,2,0,1,2,0,1,0.0,1,1,0,1,1,4,4,0
65,Daniele Bonera,ITA,DF,Villarreal,37,1981,2.6,2,2,2,0,0,1,1,100.0,0,5,5,0,4,6,10,0
66,Ryad Boudebouz,ALG,MF|FW,Celta Vigo,28,1990,8.0,14,4,4,6,4,3,8,37.5,5,9,1,8,3,17,9,0
67,Ryad Boudebouz,ALG,MF|FW,Betis,28,1990,6.0,8,4,4,1,3,4,10,40.0,6,5,1,4,5,13,2,0
68,Sofiane Boufal,MAR,MF|FW,Celta Vigo,24,1993,23.2,35,21,18,11,6,15,47,31.9,32,24,0,24,10,45,12,0
69,Yassine Bounou,MAR,GK,Girona,27,1991,31.8,0,0,0,0,0,0,2,0.0,2,0,0,0,1,1,7,2
70,Martin Braithwaite,DEN,FW,Leganés,27,1991,15.6,5,3,0,0,5,0,4,0.0,4,9,0,9,3,8,4,0
71,Darko Brašanac,SRB,MF,Alavés,26,1992,17.6,32,16,15,13,4,10,26,38.5,16,17,4,13,13,45,19,0
72,Rajko Brežančić,SRB,DF,Huesca,28,1989,0.7,1,0,0,0,1,0,0,,0,0,0,0,0,1,0,0
73,Burgui,ESP,MF|FW,Alavés,24,1993,6.2,6,6,4,2,0,1,3,33.3,2,4,0,4,0,6,2,1
74,Sergio Busquets,ESP,MF,Barcelona,30,1988,30.2,90,60,35,45,10,41,89,46.1,48,43,8,35,54,144,22,1
75,Unai Bustinza,ESP,DF,Leganés,26,1992,22.5,41,31,25,14,2,17,33,51.5,16,31,13,18,53,94,110,2
76,Erick Cabaco,URU,DF,Levante,23,1995,18.1,22,13,19,3,0,12,29,41.4,17,29,14,15,29,51,69,0
77,Gustavo Cabral,ARG,DF,Celta Vigo,32,1985,21.1,37,26,28,7,2,17,27,63.0,10,31,11,20,33,70,102,1
78,Leandro Cabrera,URU,DF,Getafe,27,1991,31.0,47,26,28,17,2,24,41,58.5,17,29,16,13,52,99,216,2
79,Jordi Calavera,ESP,DF,Eibar,22,1995,0.0,0,0,0,0,0,0,0,,0,0,0,0,0,0,0,0
80,Fernando Calero,ESP,DF,Valladolid,22,1995,34.8,51,31,33,18,0,23,38,60.5,15,55,31,24,55,106,170,0
81,Jonathan Calleri,ARG,FW,Alavés,24,1993,31.9,20,13,3,11,6,1,24,4.2,23,34,7,27,7,27,53,0
82,Juanjo Camacho,ESP,MF|DF,Huesca,37,1980,0.4,1,1,1,0,0,1,1,100.0,0,0,0,0,0,1,1,0
83,Sergio Camello,ESP,FW,Atlético Madrid,17,2001,0.5,1,0,1,0,0,1,1,100.0,0,0,0,0,0,1,0,0
84,José Campaña,ESP,MF,Levante,25,1993,35.7,65,45,31,29,5,27,86,31.4,59,51,7,44,48,113,46,1
85,Sergio Canales,ESP,MF,Betis,27,1991,29.5,44,30,19,18,7,11,53,20.8,42,34,3,31,9,53,8,1
86,Ander Capa,ESP,DF|FW,Athletic Club,26,1992,18.2,43,27,32,8,3,13,27,48.1,14,20,2,18,30,73,47,0
87,Marc Cardona,ESP,FW|MF,Eibar,23,1995,6.7,7,5,2,1,4,2,6,33.3,4,7,0,7,1,8,3,0
88,Daniel Carriço,POR,DF,Sevilla,29,1988,23.7,35,18,23,11,1,12,20,60.0,8,19,12,7,31,66,104,1
89,Guido Carrillo,ARG,FW,Leganés,27,1991,22.1,25,14,4,12,9,6,19,31.6,13,12,1,11,8,33,25,0
90,Dani Carvajal,ESP,DF,Real Madrid,26,1992,23.4,40,24,17,15,8,18,41,43.9,23,31,7,24,26,66,35,0
91,William Carvalho,POR,MF,Betis,26,1992,26.5,45,27,20,21,4,16,29,55.2,13,8,0,8,12,57,30,0
92,Casemiro,BRA,MF,Real Madrid,26,1992,25.7,86,52,44,35,7,38,94,40.4,56,52,12,40,41,127,56,3
93,Santiago Cáseres,ARG,MF,Villarreal,21,1997,17.6,67,35,20,38,9,25,57,43.9,32,22,9,13,14,81,24,1
94,Catena,ESP,DF,Rayo Vallecano,23,1994,2.0,4,4,3,1,0,2,2,100.0,0,4,2,2,8,12,8,0
95,Santi Cazorla,ESP,MF|FW,Villarreal,33,1984,29.4,69,34,32,26,11,24,69,34.8,45,35,6,29,28,97,17,1
96,Dani Ceballos,ESP,MF|FW,Real Madrid,21,1996,13.9,32,21,9,16,7,11,31,35.5,20,26,1,25,15,47,6,0
97,Charles,BRA,FW,Eibar,34,1984,19.3,7,5,1,3,3,2,13,15.4,11,14,1,13,4,11,14,0
98,Chechu,ESP,DF,Rayo Vallecano,36,1982,1.0,0,0,0,0,0,0,2,0.0,2,0,0,0,2,2,5,0
99,Chema,ESP,DF,Levante,26,1992,13.9,27,19,16,9,2,13,19,68.4,6,19,11,8,19,46,83,0
100,Denis Cheryshev,RUS,MF,Valencia,27,1990,19.0,46,32,15,22,9,17,37,45.9,20,35,3,32,15,61,16,0
101,Leandro Chichizola,ARG,GK,Getafe,28,1990,1.0,0,0,0,0,0,0,0,,0,0,0,0,0,0,1,0
102,Samuel Chukwueze,NGA,MF|FW,Villarreal,19,1999,19.0,19,11,7,10,2,9,31,29.0,22,11,2,9,10,29,2,0
103,Jasper Cillessen,NED,GK,Barcelona,29,1989,3.0,0,0,0,0,0,0,0,,0,0,0,0,0,0,3,2
104,Coke,ESP,DF,Levante,31,1987,20.2,44,27,24,17,3,26,56,46.4,30,18,8,10,40,84,54,1
105,Álex Collado,ESP,FW,Barcelona,19,1999,0.9,1,0,0,1,0,0,1,0.0,1,3,0,3,0,1,2,0
106,Santi Comesaña,ESP,MF,Rayo Vallecano,21,1996,22.6,56,35,29,25,2,22,61,36.1,39,30,5,25,30,86,45,2
107,Duje Čop,CRO,FW,Valladolid,28,1990,7.6,5,4,1,2,2,0,8,0.0,8,8,3,5,3,8,3,0
108,Francis Coquelin,FRA,MF,Valencia,27,1991,19.6,46,31,25,14,7,17,35,48.6,18,21,5,16,49,95,29,1
109,Iñigo Córdoba,ESP,FW|MF,Athletic Club,21,1997,14.7,37,23,15,17,5,14,47,29.8,33,27,0,27,17,54,13,0
110,Ángel Correa,ARG,MF|FW,Atlético Madrid,23,1995,21.3,38,19,19,12,7,10,53,18.9,43,28,5,23,17,55,20,0
111,Diego Costa,ESP,FW,Atlético Madrid,29,1988,12.4,4,1,0,4,0,1,8,12.5,7,5,0,5,2,6,6,0
112,Jaume Costa,ESP,DF,Villarreal,30,1988,16.6,33,21,26,5,2,20,33,60.6,13,12,3,9,21,54,61,0
113,David Costas,ESP,DF,Celta Vigo,23,1995,13.0,25,13,21,4,0,10,15,66.7,5,12,6,6,18,43,58,1
114,Thibaut Courtois,BEL,GK,Real Madrid,26,1992,27.0,0,0,0,0,0,0,2,0.0,2,0,0,0,2,2,5,0
115,Philippe Coutinho,BRA,FW|MF,Barcelona,26,1992,22.4,16,11,1,6,9,7,22,31.8,15,21,2,19,12,28,8,0
116,Sebastián Cristóforo,URU,MF,Getafe,24,1993,5.0,15,8,4,8,3,5,14,35.7,9,13,0,13,8,23,5,0
117,Cucho,COL,FW,Huesca,19,1999,23.9,22,13,6,10,6,6,18,33.3,12,23,2,21,9,31,21,0
118,Marc Cucurella,ESP,MF|FW,Eibar,20,1998,26.2,49,37,13,21,15,10,23,43.5,13,36,3,33,20,69,24,0
119,Iván Cuéllar,ESP,GK,Leganés,34,1984,33.9,0,0,0,0,0,0,1,0.0,1,0,0,0,2,2,10,0
120,Sergi Darder,ESP,MF,Espanyol,24,1993,30.1,60,35,23,32,5,25,69,36.2,44,18,3,15,22,82,30,0
121,Moisés Delgado,ESP,DF,Valladolid,24,1994,3.0,7,6,3,3,1,2,3,66.7,1,2,1,1,3,10,9,0
122,Ousmane Dembélé,FRA,FW|MF,Barcelona,21,1997,18.5,23,15,4,13,6,6,18,33.3,12,13,0,13,5,28,4,0
123,Franco Di Santo,ARG,FW,Rayo Vallecano,29,1989,1.9,2,2,1,0,1,1,2,50.0,1,0,0,0,0,2,2,0
124,Mouctar Diakhaby,GUI,DF,Valencia,21,1996,17.6,14,8,10,4,0,5,10,50.0,5,24,16,8,20,34,94,1
125,Brahim Díaz,ESP,FW,Real Madrid,18,1999,4.2,9,7,5,4,0,3,8,37.5,5,2,0,2,0,9,0,0
126,Javier Díaz,ESP,GK,Sevilla,21,1997,1.0,0,0,0,0,0,0,0,,0,0,0,0,0,0,0,0
127,Adrián Diéguez,ESP,DF,Huesca,22,1996,8.3,16,10,11,4,1,9,16,56.3,7,9,4,5,12,28,46,1
128,Stole Dimitrievski,MKD,GK,Rayo Vallecano,24,1993,21.0,0,0,0,0,0,0,1,0.0,1,0,0,0,0,0,8,1
129,Papakouli Diop,SEN,MF,Eibar,32,1986,26.1,66,40,14,44,8,14,34,41.2,20,21,1,20,37,103,27,0
130,Djené,TOG,DF,Getafe,26,1991,33.1,54,34,43,11,0,26,43,60.5,17,27,11,16,74,128,154,3
131,Marko Dmitrović,SRB,GK,Eibar,26,1992,24.0,0,0,0,0,0,0,0,,0,0,0,0,2,2,11,3
132,Jaume Doménech,ESP,GK,Valencia,27,1990,4.0,0,0,0,0,0,0,1,0.0,1,0,0,0,0,0,1,0
133,Cheick Doukouré,CIV,MF,Levante,25,1992,3.5,13,7,3,7,3,4,15,26.7,11,10,2,8,3,16,3,1
134,Seydou Doumbia,CIV,FW,Girona,30,1987,6.0,5,1,1,2,2,0,2,0.0,2,2,0,2,3,8,1,0
135,Óscar Duarte,CRC,DF|MF,Espanyol,29,1989,7.3,12,5,7,5,0,4,7,57.1,3,7,7,0,13,25,34,0
136,Rubén Duarte,ESP,DF,Alavés,22,1995,30.8,72,35,45,20,7,34,64,53.1,30,46,12,34,57,129,130,1
137,Hugo Duro,ESP,MF|FW,Getafe,18,1999,4.6,6,4,1,2,3,3,6,50.0,3,6,1,5,3,9,4,0
138,Raphael Dwamena,GHA,FW,Levante,22,1995,2.5,0,0,0,0,0,0,0,,0,2,1,1,0,0,2,0
139,Dennis Eckert,GER,FW,Celta Vigo,21,1997,2.4,3,2,0,1,2,0,2,0.0,2,1,0,1,2,5,3,0
140,Aritz Elustondo,ESP,DF,Real Sociedad,24,1994,25.0,47,29,31,14,2,26,41,63.4,15,23,7,16,39,86,150,0
141,Gorka Elustondo,ESP,MF|DF,Rayo Vallecano,31,1987,3.2,7,5,4,3,0,5,8,62.5,3,6,1,5,6,13,10,0
142,Rodrigo Ely,BRA,DF,Alavés,24,1993,4.8,8,5,5,3,0,5,7,71.4,2,9,7,2,7,15,30,0
143,Adri Embarba,ESP,MF|FW,Rayo Vallecano,26,1992,25.4,54,26,20,24,10,22,61,36.1,39,38,2,36,29,83,22,0
144,Emerson,BRA,FW|DF,Betis,19,1999,3.5,9,7,6,1,2,3,10,30.0,7,6,0,6,7,16,12,0
145,Youssef En-Nesyri,MAR,FW,Leganés,21,1997,23.4,16,8,6,5,5,4,24,16.7,20,18,3,15,6,22,23,0
146,Sergi Enrich,ESP,FW,Eibar,28,1990,28.7,27,17,3,11,13,7,30,23.3,23,11,1,10,6,33,14,0
147,Javier Eraso,ESP,MF|FW,Leganés,28,1990,7.0,6,3,3,2,1,0,6,0.0,6,3,1,2,7,13,4,0
148,Gonzalo Escalante,ARG,MF,Eibar,25,1993,19.9,49,28,11,35,3,19,46,41.3,27,37,2,35,21,70,21,0
149,Sergio Escudero,ESP,DF|FW,Sevilla,28,1989,17.2,43,29,20,18,5,18,35,51.4,17,22,4,18,24,67,52,0
150,Bernardo Espinosa,COL,DF,Girona,29,1989,30.3,20,14,16,4,0,8,17,47.1,9,46,31,15,40,60,197,5
151,Beñat Etxebarria,ESP,MF,Athletic Club,31,1987,22.6,47,24,14,25,8,19,59,32.2,40,18,1,17,24,71,11,0
152,Xabier Etxeita,ESP,DF,Huesca,30,1987,29.7,47,23,32,12,3,26,47,55.3,21,38,25,13,39,86,163,3
153,Zouhair Feddal,MAR,DF,Betis,29,1989,18.9,38,23,31,6,1,16,28,57.1,12,19,8,11,31,69,94,2
154,Aitor Fernández,ESP,GK,Levante,27,1991,16.0,1,0,1,0,0,1,1,100.0,0,0,0,0,1,2,10,1
155,Andrés Fernández,ESP,GK,Villarreal,31,1986,6.0,1,0,1,0,0,1,1,100.0,0,0,0,0,0,1,4,1
156,Borja Fernández,ESP,MF|DF,Valladolid,37,1981,9.3,17,12,7,9,1,6,16,37.5,10,14,2,12,14,31,25,0
157,Joaquín Fernández,ESP,DF|MF,Valladolid,22,1996,9.3,16,9,14,1,1,8,16,50.0,8,9,7,2,17,33,45,0
158,Valery Fernández,ESP,DF|FW,Girona,18,1999,9.9,20,15,13,6,1,10,17,58.8,7,15,1,14,8,28,10,0
159,David Ferreiro,ESP,MF|FW,Huesca,30,1988,25.3,36,22,13,19,4,11,64,17.2,53,27,1,26,24,60,14,2
160,Facundo Ferreyra,ARG,FW,Espanyol,27,1991,2.3,5,2,0,4,1,1,3,33.3,2,3,0,3,0,5,5,0
161,Junior Firpo,ESP,DF|FW,Betis,21,1996,21.5,38,25,16,14,8,10,24,41.7,14,27,2,25,23,61,48,0
162,Mathieu Flamini,FRA,MF,Getafe,34,1984,5.0,9,4,4,4,1,4,7,57.1,3,3,1,2,5,14,4,0
163,Pablo Fornals,ESP,MF|FW,Villarreal,22,1996,27.5,49,26,14,26,9,15,54,27.8,39,32,4,28,24,73,19,0
164,Dimitri Foulquier,FRA,MF|DF,Getafe,25,1993,20.0,29,12,10,14,5,11,22,50.0,11,23,2,21,20,49,38,0
165,Javi Fuego,ESP,MF,Villarreal,34,1984,2.6,6,3,5,1,0,4,8,50.0,4,2,0,2,3,9,9,0
166,Ramiro Funes Mori,ARG,DF|MF,Villarreal,27,1991,29.2,41,29,30,9,2,19,44,43.2,25,36,24,12,42,83,149,2
167,Javi Galán,ESP,DF|FW,Huesca,23,1994,16.0,61,39,36,23,2,34,59,57.6,25,22,1,21,19,80,52,1
168,Álex Gallar,ESP,MF|FW,Huesca,26,1992,11.2,15,9,6,5,4,8,19,42.1,11,9,1,8,9,24,5,0
169,Enric Gallego,ESP,FW,Huesca,31,1986,17.1,21,15,3,13,5,3,19,15.8,16,17,2,15,8,29,32,0
170,Álex Gálvez,ESP,DF,Rayo Vallecano,29,1989,15.7,38,28,25,13,0,14,28,50.0,14,7,2,5,45,83,69,1
171,Kévin Gameiro,FRA,FW,Valencia,31,1987,17.9,14,9,4,6,4,1,6,16.7,5,12,2,10,5,19,3,0
172,Cristian Ganea,ROU,DF,Athletic Club,26,1992,0.5,0,0,0,0,0,0,3,0.0,3,1,0,1,1,1,2,0
173,Ezequiel Garay,ARG,DF,Valencia,31,1986,23.7,20,17,15,3,2,9,18,50.0,9,30,23,7,16,36,140,0
174,Borja Garcés,ESP,FW,Atlético Madrid,18,1999,0.2,0,0,0,0,0,0,0,,0,0,0,0,0,0,0,0
175,Alberto García,ESP,GK,Rayo Vallecano,33,1985,17.0,1,1,1,0,0,1,3,33.3,2,1,0,1,2,3,1,2
176,Aleix García,ESP,MF,Girona,21,1997,18.5,37,19,17,20,0,13,36,36.1,23,21,6,15,21,58,18,0
177,Álvaro García,ESP,FW|MF,Rayo Vallecano,25,1992,19.6,22,19,11,7,4,4,25,16.0,21,24,0,24,19,41,30,0
178,Borja García,ESP,MF|FW,Girona,27,1990,29.2,39,27,17,15,7,22,44,50.0,22,23,2,21,38,77,17,0
179,Dani García,ESP,MF,Athletic Club,28,1990,27.5,56,34,21,32,3,24,63,38.1,39,28,8,20,49,105,46,1
180,Javi García,ESP,DF|MF,Betis,31,1987,5.8,3,1,3,0,0,2,3,66.7,1,5,1,4,5,8,27,0
181,Manu García,ESP,MF,Alavés,32,1986,25.9,83,48,29,40,14,24,77,31.2,53,42,7,35,23,106,67,0
182,Raúl García,ESP,MF|FW,Athletic Club,32,1986,26.3,61,41,13,37,11,22,68,32.4,46,56,1,55,21,82,39,0
183,Raúl García,ESP,DF,Leganés,29,1989,4.2,8,6,4,4,0,6,8,75.0,2,5,2,3,6,14,28,1
184,Raúl García,ESP,DF,Girona,29,1989,9.4,21,12,11,7,3,11,16,68.8,5,14,4,10,11,32,35,1
185,Sergio García,ESP,FW|MF,Espanyol,35,1983,16.5,18,10,4,11,3,3,16,18.8,13,6,1,5,10,28,4,0
186,Mario Gaspar,ESP,DF,Villarreal,27,1990,28.9,62,43,39,17,6,29,49,59.2,20,48,11,37,42,104,91,0
187,Bryan Gil,ESP,MF|FW,Sevilla,17,2001,1.9,6,4,4,1,1,1,5,20.0,4,0,0,0,1,7,0,0
188,Joris Gnagnon,FRA,DF|MF,Sevilla,21,1997,5.0,11,8,6,4,1,4,7,57.1,3,2,2,0,10,21,16,0
189,Diego Godín,URU,DF,Atlético Madrid,32,1986,27.9,52,30,33,19,0,20,42,47.6,22,22,9,13,45,97,141,2
190,Ibai Gómez,ESP,FW,Athletic Club,28,1989,6.4,6,3,3,2,1,4,9,44.4,5,8,1,7,2,8,8,0
191,Ibai Gómez,ESP,MF|FW,Alavés,28,1989,16.1,14,8,9,3,2,6,19,31.6,13,10,0,10,8,22,17,0
192,Maxi Gómez,URU,FW,Celta Vigo,21,1996,32.9,6,4,1,4,1,1,12,8.3,11,3,0,3,2,8,43,0
193,Moi Gómez,ESP,MF,Huesca,24,1994,33.9,42,28,15,25,2,11,46,23.9,35,27,3,24,28,70,27,0
194,Sergi Gómez,ESP,DF,Sevilla,26,1992,30.7,49,38,33,12,4,18,28,64.3,10,30,20,10,40,89,135,1
195,Maxime Gonalons,FRA,MF,Sevilla,29,1989,6.0,8,4,2,5,1,1,15,6.7,14,10,4,6,5,13,12,0
196,Álvaro González,ESP,DF,Villarreal,28,1990,32.9,49,35,33,14,2,25,35,71.4,10,34,24,10,37,86,177,2
197,Bruno González,ESP,DF,Getafe,28,1990,18.9,23,10,14,8,1,9,18,50.0,9,13,6,7,22,45,110,0
198,Cristo González,ESP,FW,Real Madrid,20,1997,0.5,1,0,0,1,0,0,0,,0,0,0,0,1,2,0,0
199,Andoni Gorosabel,ESP,DF,Real Sociedad,21,1996,5.1,16,9,10,5,1,8,13,61.5,5,5,1,4,4,20,20,1
200,Álex Granell,ESP,MF|DF,Girona,29,1988,26.6,64,28,30,31,3,34,83,41.0,49,34,5,29,35,99,36,1
201,Esteban Granero,ESP,MF,Espanyol,31,1987,22.4,50,32,26,18,6,17,50,34.0,33,42,8,34,26,76,34,2
202,Antoine Griezmann,FRA,FW|MF,Atlético Madrid,27,1991,35.5,31,19,8,13,10,8,28,28.6,20,18,1,17,12,43,21,0
203,Andrés Guardado,MEX,MF|DF,Betis,31,1986,25.9,24,15,9,12,3,11,47,23.4,36,27,1,26,28,52,28,1
204,Sergi Guardiola,ESP,FW,Valladolid,27,1991,16.8,19,11,1,10,8,2,13,15.4,11,12,0,12,5,24,17,0
205,Sergi Guardiola,ESP,MF|FW,Getafe,27,1991,0.3,1,1,0,1,0,0,0,,0,0,0,0,0,1,0,0
206,Gonçalo Guedes,POR,MF|FW,Valencia,21,1996,16.3,31,13,16,12,3,14,43,32.6,29,15,0,15,7,38,1,0
207,Javi Guerra,ESP,FW|MF,Rayo Vallecano,36,1982,2.6,3,3,1,1,1,0,3,0.0,3,2,0,2,1,4,0,0
208,Francis Guerrero,ESP,DF|FW,Betis,22,1996,19.8,51,28,25,16,10,23,41,56.1,18,15,1,14,21,72,47,4
209,Ander Guevara,ESP,MF,Real Sociedad,21,1997,1.0,3,1,0,3,0,2,6,33.3,4,1,0,1,1,4,0,0
210,John Guidetti,SWE,FW,Alavés,26,1992,7.0,4,1,0,3,1,0,4,0.0,4,4,0,4,1,5,6,0
211,Gerard Gumbau,ESP,MF,Leganés,23,1994,13.3,22,16,9,13,0,6,25,24.0,19,15,2,13,13,35,13,0
212,Serdar Gürler,TUR,MF|FW,Huesca,26,1991,5.4,5,5,3,2,0,3,11,27.3,8,8,0,8,1,6,2,0
213,Gorka Guruzeta,ESP,MF|FW,Athletic Club,21,1996,0.6,1,1,1,0,0,0,2,0.0,2,1,0,1,2,3,0,0
214,Hacen,MTN,MF,Valladolid,20,1997,0.0,0,0,0,0,0,0,0,,0,1,0,1,1,1,1,0
215,Munir El Haddadi,MAR,FW|MF,Sevilla,22,1995,11.6,17,10,5,7,5,2,7,28.6,5,15,0,15,6,23,9,0
216,Munir El Haddadi,MAR,FW,Barcelona,22,1995,1.7,3,3,1,1,1,1,3,33.3,2,1,0,1,0,3,1,0
217,Uche Henry Agbo,NGA,MF,Rayo Vallecano,22,1995,4.1,7,4,3,4,0,5,10,50.0,5,3,1,2,6,13,1,0
218,Mario Hermoso,ESP,DF,Espanyol,23,1995,31.2,38,24,29,7,2,21,39,53.8,18,34,25,9,37,75,175,2
219,Lucas Hernández,FRA,DF,Atlético Madrid,22,1996,12.4,35,25,20,14,1,17,20,85.0,3,17,9,8,14,49,49,0
220,Theo Hernández,FRA,DF,Real Sociedad,20,1997,22.0,54,33,30,15,9,28,44,63.6,16,21,5,16,33,87,42,3
221,Yangel Herrera,VEN,MF|DF,Huesca,20,1998,12.8,48,24,18,25,5,23,43,53.5,20,13,1,12,14,62,32,0
222,Iago Herrerín,ESP,GK,Athletic Club,30,1988,31.0,0,0,0,0,0,0,2,0.0,2,0,0,0,0,0,11,2
223,Pablo Hervías,ESP,MF,Valladolid,25,1993,1.8,1,0,0,1,0,0,1,0.0,1,0,0,0,2,3,0,0
224,Pablo Hervías,ESP,MF,Eibar,25,1993,2.0,1,1,0,1,0,0,4,0.0,4,2,0,2,0,1,0,0
225,Andrew Hjulsager,DEN,MF|FW,Celta Vigo,23,1995,4.0,16,10,11,2,3,2,18,11.1,16,4,0,4,2,18,1,0
226,Wesley Hoedt,NED,DF,Celta Vigo,24,1994,9.9,17,11,15,2,0,12,17,70.6,5,17,11,6,11,28,58,3
227,Robert Ibáñez,ESP,MF,Getafe,25,1993,0.8,2,2,1,1,0,0,1,0.0,1,3,0,3,0,2,0,0
228,Vicente Iborra,ESP,MF,Villarreal,30,1988,18.5,31,18,22,5,4,14,37,37.8,23,25,7,18,22,53,41,1
229,Borja Iglesias,ESP,FW,Espanyol,25,1993,34.2,23,14,7,8,8,5,24,20.8,19,14,6,8,7,30,41,0
230,Asier Illarramendi,ESP,MF,Real Sociedad,28,1990,20.2,39,24,22,14,3,21,51,41.2,30,36,9,27,31,70,46,1
231,Giannelli Imbula,COD,MF,Rayo Vallecano,25,1992,19.2,14,7,6,7,1,5,12,41.7,7,12,3,9,8,22,6,0
232,Pablo Insua,ESP,DF,Huesca,24,1993,8.6,23,10,14,9,0,8,15,53.3,7,2,0,2,12,35,40,0
233,Takashi Inui,JPN,MF|FW,Alavés,30,1988,9.2,9,5,6,2,1,5,18,27.8,13,5,0,5,4,13,3,0
234,Takashi Inui,JPN,MF,Betis,30,1988,4.2,4,3,0,4,0,3,7,42.9,4,3,0,3,1,5,1,0
235,Gorka Iraizoz,ESP,GK,Girona,37,1981,6.2,1,0,1,0,0,1,1,100.0,0,0,0,0,1,2,7,0
236,Carlos Isaac,ESP,DF,Atlético Madrid,20,1998,1.0,0,0,0,0,0,0,2,0.0,2,2,0,2,1,1,2,0
237,Isco,ESP,MF|FW,Real Madrid,26,1992,13.2,29,14,14,8,7,14,34,41.2,20,9,1,8,6,35,3,0
238,Manuel Iturra,CHI,MF,Villarreal,34,1984,0.8,2,0,0,2,0,0,0,,0,1,0,1,2,4,2,0
239,Ander Iturraspe,ESP,MF,Athletic Club,29,1989,1.1,2,2,1,1,0,1,1,100.0,0,0,0,0,6,8,2,0
240,Ivi,ESP,MF|FW,Valladolid,24,1994,0.2,0,0,0,0,0,0,0,,0,0,0,0,0,0,0,0
241,Adnan Januzaj,BEL,FW|MF,Real Sociedad,23,1995,13.9,11,8,5,2,4,3,13,23.1,10,7,0,7,6,17,6,0
242,Jason,ESP,DF|FW,Levante,24,1994,25.9,44,25,22,11,11,20,71,28.2,51,25,4,21,46,90,27,0
243,Mathias Jensen,DEN,MF|FW,Celta Vigo,22,1996,2.6,4,2,2,2,0,2,9,22.2,7,2,0,2,4,8,1,0
244,Jesé,ESP,FW|MF,Betis,25,1993,8.7,7,4,3,3,1,2,8,25.0,6,8,0,8,1,8,1,0
245,Joaquín,ESP,FW|MF,Betis,37,1981,18.8,10,4,4,2,4,3,7,42.9,4,13,2,11,14,24,31,1
246,Jony,ESP,MF|FW,Alavés,27,1991,33.0,20,14,6,7,7,7,37,18.9,30,18,0,18,22,42,12,2
247,Joan Jordán,ESP,MF,Eibar,24,1994,31.9,63,40,16,38,9,28,80,35.0,52,38,4,34,32,95,18,1
248,Willian José,BRA,FW,Real Sociedad,26,1991,26.3,5,3,1,3,1,2,7,28.6,5,11,5,6,1,6,27,0
249,Aleksandar Jovanović,SRB,GK,Huesca,25,1992,12.0,0,0,0,0,0,0,0,,0,0,0,0,1,1,3,0
250,Jozabed,ESP,MF,Celta Vigo,27,1991,12.8,19,10,8,8,3,8,24,33.3,16,8,2,6,9,28,13,2
251,Miguel Juan Llambrich,ESP,DF|FW,Villarreal,22,1996,6.0,21,14,11,9,1,6,14,42.9,8,9,2,7,12,33,17,0
252,Juanfran,ESP,DF|FW,Leganés,29,1988,16.2,20,12,13,5,2,9,16,56.3,7,9,4,5,19,39,37,0
253,Juanfran,ESP,DF,Atlético Madrid,33,1985,17.9,35,22,27,5,3,24,38,63.2,14,13,5,8,19,54,36,1
254,Juanmi,ESP,FW|MF,Real Sociedad,25,1993,16.9,21,12,7,11,3,8,22,36.4,14,12,0,12,16,37,13,0
255,Juanpe,ESP,DF,Girona,27,1991,30.7,48,25,32,15,1,24,45,53.3,21,31,15,16,57,105,138,0
256,Juanpi,VEN,MF|FW,Huesca,24,1994,7.4,16,6,9,5,2,4,12,33.3,8,15,0,15,6,22,3,0
257,David Juncà,ESP,DF,Celta Vigo,24,1993,19.5,55,30,40,13,2,28,46,60.9,18,27,6,21,35,90,63,1
258,Vinicius Júnior,BRA,FW|MF,Real Madrid,18,2000,9.7,10,6,3,6,1,3,16,18.8,13,6,1,5,7,17,1,0
259,Gaël Kakuta,COD,MF|FW,Rayo Vallecano,27,1991,8.0,12,7,5,5,2,2,10,20.0,8,4,1,3,9,21,9,0
260,Nikola Kalinić,CRO,FW,Atlético Madrid,30,1988,7.1,6,4,2,4,0,1,3,33.3,2,1,0,1,2,8,2,0
261,Lee Kang-in,KOR,MF|FW,Valencia,17,2001,0.3,2,0,1,1,0,1,3,33.3,2,0,0,0,1,3,0,0
262,Wilfrid Kaptoum,CMR,MF,Betis,22,1996,8.6,15,6,4,10,1,5,11,45.5,6,9,1,8,10,25,6,2
263,Keko,ESP,MF|FW,Valladolid,26,1991,17.0,42,18,21,15,6,18,50,36.0,32,20,1,19,14,56,17,0
264,Kiké,ESP,FW,Eibar,28,1989,14.4,7,4,1,2,4,1,5,20.0,4,18,0,18,4,11,6,0
265,Simon Kjær,DEN,DF,Sevilla,29,1989,22.3,29,19,25,3,1,9,16,56.3,7,41,34,7,27,56,136,0
266,Kenan Kodro,BIH,FW|MF,Athletic Club,24,1993,1.8,3,1,1,1,1,1,3,33.3,2,1,0,1,0,3,0,0
267,Koke,ESP,MF,Atlético Madrid,26,1992,28.7,84,46,41,32,11,34,86,39.5,52,25,5,20,31,115,37,1
268,Geoffrey Kondogbia,CTA,MF,Valencia,25,1993,13.8,47,33,18,23,6,12,27,44.4,15,20,7,13,27,74,22,2
269,Vasyl Kravets,UKR,DF|FW,Leganés,20,1997,5.3,16,11,8,6,2,6,13,46.2,7,5,1,4,4,20,10,1
270,Toni Kroos,GER,MF,Real Madrid,28,1990,24.7,51,35,18,24,9,14,57,24.6,43,25,4,21,14,65,13,1
271,Víctor Laguardia,ESP,DF,Alavés,28,1989,36.0,47,34,37,10,0,24,33,72.7,9,42,19,23,53,100,232,0
272,Diego Lainez,MEX,FW|MF,Betis,18,2000,3.9,4,4,0,3,1,1,1,100.0,0,2,0,2,1,5,2,0
273,Toni Lato,ESP,DF,Valencia,20,1997,3.0,6,4,4,1,1,1,5,20.0,4,9,3,6,6,12,13,0
274,Miguel Layún,MEX,MF|DF,Villarreal,30,1988,5.6,8,2,0,7,1,2,6,33.3,4,8,2,6,1,9,10,0
275,Robin Le Normand,ESP,DF,Real Sociedad,21,1996,3.2,5,2,2,3,0,1,3,33.3,2,3,0,3,4,9,13,1
276,Wu Lei,CHN,FW|MF,Espanyol,26,1991,11.8,13,6,5,6,2,5,16,31.3,11,9,0,9,7,20,7,0
277,Iñigo Lekue,ESP,DF,Athletic Club,25,1993,2.3,5,2,3,2,0,2,7,28.6,5,4,0,4,4,9,11,0
278,Thomas Lemar,FRA,MF,Atlético Madrid,22,1995,20.2,38,21,23,11,4,19,42,45.2,23,26,1,25,22,60,7,1
279,Clément Lenglet,FRA,DF,Barcelona,23,1995,21.5,47,29,26,19,2,22,36,61.1,14,30,20,10,21,68,70,0
280,Pedro León,ESP,MF|FW,Eibar,31,1986,4.7,7,4,2,2,3,4,7,57.1,3,10,0,10,4,11,2,0
281,Sergio León,ESP,FW|MF,Betis,29,1989,7.1,4,2,2,1,1,2,8,25.0,6,4,0,4,2,6,6,0
282,Diego Llorente,ESP,DF,Real Sociedad,24,1993,19.5,26,15,16,8,2,17,29,58.6,12,27,15,12,26,52,83,2
283,Marcos Llorente,ESP,MF,Real Madrid,23,1995,6.0,16,12,7,7,2,8,18,44.4,10,8,0,8,7,23,12,0
284,Giovani Lo Celso,ARG,MF|FW,Betis,22,1996,26.6,52,31,16,28,8,9,35,25.7,26,24,1,23,17,69,8,0
285,Stanislav Lobotka,SVK,MF,Celta Vigo,23,1994,27.7,30,19,10,17,3,9,32,28.1,23,15,1,14,26,56,18,1
286,Samuele Longo,ITA,FW,Huesca,26,1992,6.2,4,3,2,2,0,0,6,0.0,6,4,0,4,1,5,7,0
287,Álex López,ESP,MF,Espanyol,21,1997,1.2,3,1,1,2,0,2,3,66.7,1,0,0,0,3,6,1,0
288,David López,ESP,DF,Espanyol,28,1989,20.2,27,18,15,10,2,10,22,45.5,12,18,12,6,28,55,65,2
289,Diego López,ESP,GK,Espanyol,36,1981,38.0,0,0,0,0,0,0,0,,0,0,0,0,2,2,9,3
290,Javi López,ESP,DF,Espanyol,32,1986,21.6,63,40,37,22,4,28,60,46.7,32,27,5,22,40,103,90,0
291,Lluis López,ESP,DF,Espanyol,21,1997,5.8,5,3,4,1,0,3,6,50.0,3,6,2,4,7,12,21,0
292,Pedro López Muñoz,ESP,DF,Levante,34,1983,5.2,5,3,5,0,0,3,7,42.9,4,8,3,5,8,13,7,0
293,Pau López,ESP,GK,Betis,23,1994,33.0,0,0,0,0,0,0,2,0.0,2,1,0,1,2,2,17,2
294,Roberto López,ESP,MF,Real Sociedad,18,2000,0.3,0,0,0,0,0,0,1,0.0,1,1,0,1,1,1,2,0
295,Unai López,ESP,MF,Athletic Club,22,1995,3.6,7,5,3,2,2,2,12,16.7,10,10,3,7,1,8,2,0
296,Anthony Lozano,HON,FW|MF,Girona,25,1993,8.1,6,5,3,3,0,0,6,0.0,6,7,1,6,0,6,6,0
297,Filipe Luís,BRA,DF,Atlético Madrid,32,1985,22.6,66,36,33,25,8,32,58,55.2,26,18,3,15,44,110,47,0
298,José Luis Gayà,ESP,DF,Valencia,23,1995,34.9,83,59,56,20,7,46,80,57.5,34,48,6,42,43,126,105,1
299,José Luis Morales,ESP,FW|MF,Levante,31,1987,35.5,21,15,6,10,5,8,49,16.3,41,22,1,21,12,33,17,0
300,Luisinho,POR,DF,Huesca,33,1985,5.6,14,10,9,5,0,10,17,58.8,7,6,1,5,16,30,17,0
301,Douglas Luiz,BRA,MF,Girona,20,1998,16.6,34,19,13,20,1,9,38,23.7,29,19,7,12,21,55,26,0
302,Antonio Luna,ESP,DF|FW,Levante,27,1991,14.0,14,10,6,7,1,6,23,26.1,17,22,7,15,15,29,48,1
303,Andriy Lunin,UKR,GK,Leganés,19,1999,4.1,0,0,0,0,0,0,0,,0,0,0,0,0,0,0,0
304,Nemanja Maksimović,SRB,MF,Getafe,23,1995,35.7,77,45,21,51,5,21,61,34.4,40,60,15,45,71,148,33,0
305,Malcom,BRA,FW|MF,Barcelona,21,1997,6.8,3,2,0,1,2,2,3,66.7,1,7,0,7,1,4,1,0
306,Hugo Mallo,ESP,DF,Celta Vigo,27,1991,34.4,73,41,41,27,5,27,52,51.9,25,44,13,31,50,123,135,1
307,Aïssa Mandi,ALG,DF,Betis,26,1991,34.0,52,34,27,20,5,12,29,41.4,17,39,23,16,41,93,71,2
308,Martín Mantovani,ARG,DF,Huesca,34,1984,7.8,15,9,12,3,0,6,11,54.5,5,4,3,1,22,37,48,0
309,Fran Manzanara,ESP,DF|MF,Levante,21,1996,1.7,7,5,3,3,1,4,4,100.0,0,3,2,1,1,8,7,0
310,Marcelo,BRA,DF,Real Madrid,30,1988,20.6,34,19,17,12,5,15,39,38.5,24,19,2,17,17,51,21,0
311,Óscar de Marcos,ESP,DF|FW,Athletic Club,29,1989,26.9,60,32,34,17,9,29,62,46.8,33,29,4,25,27,87,62,0
312,Miguel Marí,ESP,MF,Eibar,21,1997,0.8,0,0,0,0,0,0,2,0.0,2,0,0,0,1,1,2,0
313,José María Giménez,URU,DF,Atlético Madrid,23,1995,19.7,26,15,20,6,0,13,26,50.0,13,27,14,13,44,70,128,2
314,Mariano,DOM,FW,Real Madrid,24,1993,5.0,2,1,1,1,0,0,3,0.0,3,2,0,2,0,2,2,0
315,Adrián Marín,ESP,DF|MF,Alavés,21,1997,3.2,13,8,8,5,0,4,7,57.1,3,1,0,1,7,20,13,0
316,Guillermo Maripán,CHI,DF,Alavés,24,1994,22.3,46,26,34,12,0,26,38,68.4,12,35,19,16,40,86,133,2
317,Roger Martí,ESP,FW,Levante,27,1991,21.0,8,6,1,4,3,1,19,5.3,18,14,1,13,4,12,9,0
318,Iñigo Martínez,ESP,DF,Athletic Club,27,1991,32.2,53,26,36,16,1,23,37,62.2,14,24,14,10,69,122,144,0
319,Gelson Martins,POR,FW|MF,Atlético Madrid,23,1995,2.5,5,3,3,1,1,3,4,75.0,1,1,0,1,1,6,1,0
320,Jordi Masip,ESP,GK,Valladolid,29,1989,35.0,1,1,1,0,0,0,0,,0,1,0,1,1,2,3,3
321,Jaime Mata,ESP,FW|MF,Getafe,29,1988,27.0,30,21,8,14,8,7,26,26.9,19,14,0,14,17,47,27,0
322,Borja Mayoral,ESP,FW,Levante,21,1997,18.0,9,4,1,6,2,5,16,31.3,11,10,1,9,5,14,5,0
323,Róbert Mazáň,SVK,DF,Celta Vigo,24,1994,1.0,3,3,3,0,0,2,2,100.0,0,2,0,2,3,6,0,0
324,Álvaro Medrán,ESP,MF,Rayo Vallecano,24,1994,12.8,15,8,5,6,4,6,21,28.6,15,10,1,9,17,32,9,0
325,Óscar Melendo,ESP,MF|FW,Espanyol,20,1997,22.2,17,8,7,6,4,10,26,38.5,16,17,1,16,13,30,9,0
326,Gonzalo Melero,ESP,MF,Huesca,24,1994,14.9,26,23,5,19,2,11,48,22.9,37,14,4,10,2,28,23,0
327,Arthur Melo,BRA,MF,Barcelona,21,1996,15.9,15,10,5,6,4,6,13,46.2,7,8,0,8,9,24,9,1
328,Brais Méndez,ESP,MF|FW,Celta Vigo,21,1997,26.1,61,31,23,29,9,14,53,26.4,39,32,3,29,24,85,24,0
329,Gabriel Mercado,ARG,DF,Sevilla,31,1987,19.3,35,23,21,12,2,18,36,50.0,18,24,12,12,26,61,75,1
330,Mikel Merino,ESP,MF,Real Sociedad,22,1996,22.8,50,28,19,25,6,14,52,26.9,38,37,2,35,29,79,37,1
331,Sabin Merino,ESP,FW|MF,Leganés,26,1992,3.3,1,1,0,0,1,1,1,100.0,0,1,0,1,0,1,4,0
332,Martín Merquelanz,ESP,MF,Real Sociedad,23,1995,0.1,0,0,0,0,0,0,0,,0,0,0,0,0,0,0,0
333,Roque Mesa,ESP,MF,Sevilla,29,1989,19.4,46,27,16,22,8,15,38,39.5,23,16,0,16,14,60,12,4
334,Lionel Messi,ARG,FW,Barcelona,31,1987,30.1,12,7,5,3,4,1,17,5.9,16,10,0,10,3,15,1,0
335,Míchel,ESP,MF,Valladolid,30,1988,28.4,60,38,25,31,4,18,73,24.7,55,40,4,36,43,103,30,1
336,Miguel,ESP,FW,Valladolid,18,1999,0.1,0,0,0,0,0,0,1,0.0,1,0,0,0,1,1,0,0
337,Pere Milla,ESP,MF|FW,Eibar,25,1992,3.8,7,6,1,5,1,0,5,0.0,5,4,1,3,2,9,1,0
338,Santi Mina,ESP,FW,Valencia,22,1995,20.6,17,10,1,15,1,3,25,12.0,22,19,2,17,4,21,20,0
339,Ignasi Miquel,ESP,DF,Getafe,25,1992,3.5,1,0,0,1,0,1,2,50.0,1,4,4,0,5,6,25,0
340,Jorge Miramón,ESP,DF,Huesca,29,1989,27.7,73,55,49,17,7,34,53,64.2,19,34,11,23,44,117,65,1
341,Luka Modrić,CRO,MF,Real Madrid,32,1985,29.0,49,30,11,25,13,14,48,29.2,34,20,3,17,31,80,7,1
342,Johan Mojica,COL,FW|MF,Girona,25,1992,0.2,1,1,1,0,0,0,0,,0,0,0,0,0,1,0,0
343,Jorge Molina,ESP,FW,Getafe,36,1982,29.4,12,9,1,4,7,2,15,13.3,13,22,0,22,7,19,26,1
344,Victor Mollejo,ESP,FW|DF,Atlético Madrid,17,2001,0.7,0,0,0,0,0,0,2,0.0,2,0,0,0,0,0,0,0
345,Francisco Montero,ESP,DF,Atlético Madrid,19,1999,4.5,8,4,5,3,0,5,6,83.3,1,10,4,6,5,13,18,1
346,Emre Mor,TUR,FW|MF,Celta Vigo,21,1997,4.1,7,4,1,3,3,2,7,28.6,5,5,0,5,3,10,1,0
347,Álvaro Morata,ESP,FW,Atlético Madrid,25,1992,12.0,20,14,2,7,11,3,10,30.0,7,7,0,7,5,25,13,0
348,Álex Moreno,ESP,DF,Rayo Vallecano,25,1993,34.8,63,40,41,18,4,29,53,54.7,24,35,9,26,41,104,97,0
349,Gerard Moreno,ESP,FW,Villarreal,26,1992,25.7,22,12,2,15,5,8,27,29.6,19,23,9,14,9,31,39,0
350,Héctor Moreno,MEX,DF,Real Sociedad,30,1988,21.5,16,9,12,4,0,9,17,52.9,8,34,19,15,31,47,73,0
351,Sergio Moreno,ESP,FW,Rayo Vallecano,19,1999,0.2,0,0,0,0,0,0,0,,0,0,0,0,0,0,0,0
352,Manu Morlanes,ESP,MF,Villarreal,19,1999,6.8,21,11,9,9,3,7,19,36.8,12,7,3,4,5,26,9,0
353,Loren Morón,ESP,FW,Betis,24,1993,21.7,18,12,4,11,3,6,27,22.2,21,24,1,23,6,24,18,0
354,Toni Moya,ESP,DF,Atlético Madrid,20,1998,1.0,2,2,2,0,0,0,1,0.0,1,0,0,0,0,2,3,0
355,Javi Moyano,ESP,DF,Valladolid,32,1986,23.3,25,17,17,6,2,15,30,50.0,15,20,9,11,25,50,88,2
356,Iker Muniain,ESP,MF|FW,Athletic Club,25,1992,26.5,29,20,10,14,5,6,29,20.7,23,17,3,14,12,41,6,0
357,Marc Muniesa,ESP,DF|MF,Girona,26,1992,15.6,49,34,27,17,5,15,28,53.6,13,18,6,12,37,86,49,1
358,Aihen Muñoz,ESP,DF,Real Sociedad,20,1997,10.6,13,8,11,2,0,10,19,52.6,9,19,9,10,7,20,26,0
359,Ezequiel Muñoz,ARG,DF,Leganés,27,1990,2.3,3,2,1,2,0,0,0,,0,3,1,2,1,4,10,0
360,Joaquín Muñoz,ESP,FW,Atlético Madrid,19,1999,0.0,0,0,0,0,0,0,0,,0,0,0,0,0,0,0,0
361,Luis Muriel,COL,MF|FW,Sevilla,27,1991,1.4,0,0,0,0,0,0,6,0.0,6,3,0,3,0,0,1,0
362,Jeison Murillo,COL,DF,Valencia,26,1992,1.0,2,1,1,1,0,1,2,50.0,1,1,0,1,2,4,6,0
363,Jeison Murillo,COL,DF,Barcelona,26,1992,1.3,2,2,1,1,0,0,3,0.0,3,0,0,0,0,2,5,1
364,Damián Musto,ARG,MF|DF,Huesca,31,1987,18.7,52,34,22,27,3,16,33,48.5,17,30,11,19,34,86,54,1
365,Nacho,ESP,DF,Valladolid,29,1989,35.0,110,66,73,30,7,67,100,67.0,33,43,10,33,45,155,113,2
366,Nacho,ESP,DF,Real Madrid,28,1990,18.9,26,19,14,7,5,11,22,50.0,11,19,7,12,32,58,65,1
367,Naldo,BRA,DF,Espanyol,29,1988,15.1,18,10,9,5,4,6,10,60.0,4,19,13,6,26,44,112,1
368,Ximo Navarro,ESP,DF,Alavés,28,1990,28.1,57,35,44,12,1,32,45,71.1,13,25,11,14,47,104,143,1
369,Jesús Navas,ESP,DF|FW,Sevilla,32,1985,30.1,28,21,15,11,2,16,24,66.7,8,23,5,18,29,57,62,0
370,Keylor Navas,CRC,GK,Real Madrid,31,1986,10.0,0,0,0,0,0,0,0,,0,0,0,0,1,1,5,0
371,Raúl Navas,ESP,DF,Real Sociedad,30,1988,14.6,23,14,20,3,0,13,21,61.9,8,20,9,11,20,43,60,1
372,Neto,BRA,GK,Valencia,29,1989,34.0,2,0,2,0,0,2,3,66.7,1,0,0,0,1,3,9,3
373,Saúl Ñíguez,ESP,MF|DF,Atlético Madrid,23,1994,32.5,83,56,35,41,7,32,81,39.5,49,57,10,47,42,125,86,1
374,Peru Nolaskoain,ESP,DF,Athletic Club,19,1998,5.2,11,8,7,4,0,5,9,55.6,4,11,6,5,10,21,18,0
375,Nolito,ESP,FW|DF,Sevilla,31,1986,0.8,3,2,1,1,1,1,2,50.0,1,2,0,2,0,3,1,0
376,Unai Núñez,ESP,DF,Athletic Club,21,1997,11.8,15,11,11,4,0,7,11,63.6,4,20,12,8,28,43,60,2
377,Allan Nyom,CMR,DF|FW,Leganés,30,1988,19.0,32,24,20,10,2,12,17,70.6,5,7,2,5,20,52,35,0
378,Jan Oblak,SVN,GK,Atlético Madrid,25,1993,37.0,1,0,1,0,0,1,1,100.0,0,0,0,0,1,2,13,1
379,Álvaro Odriozola,ESP,DF,Real Madrid,22,1995,13.1,28,25,13,11,4,14,18,77.8,4,11,1,10,11,39,17,1
380,Dani Ojeda,ESP,MF|DF,Leganés,23,1994,2.1,3,2,2,0,1,1,3,33.3,2,2,0,2,2,5,2,0
381,Lucas Olaza,URU,DF,Celta Vigo,24,1994,10.0,29,18,19,8,2,14,18,77.8,4,13,6,7,8,37,18,0
382,Oier Olazábal,ESP,GK,Levante,28,1989,21.0,1,1,1,0,0,1,2,50.0,1,1,0,1,1,2,15,2
383,Kiko Olivas,ESP,DF,Valladolid,29,1988,34.4,51,38,35,15,1,22,48,45.8,26,31,18,13,46,97,173,2
384,Paulo Oliveira,POR,DF,Eibar,26,1992,24.9,49,39,33,16,0,28,44,63.6,16,25,10,15,36,85,116,0
385,Mathías Olivera,URU,DF|MF,Getafe,20,1997,11.2,24,17,11,8,5,10,18,55.6,8,25,2,23,10,34,22,0
386,Kenneth Omeruo,NGA,DF,Leganés,24,1993,27.0,49,27,41,8,0,20,29,69.0,9,23,11,12,37,86,159,3
387,Fabián Orellana,CHI,MF|FW,Eibar,32,1986,30.4,44,21,14,16,14,9,42,21.4,33,17,0,17,19,63,4,0
388,Mikel Oyarzabal,ESP,FW|MF,Real Sociedad,21,1997,35.0,36,20,15,15,6,12,49,24.5,37,54,3,51,14,50,26,0
389,Fernando Pacheco,ESP,GK,Alavés,26,1992,35.0,0,0,0,0,0,0,1,0.0,1,0,0,0,1,1,23,0
390,Rubén Pardo,ESP,MF|FW,Real Sociedad,25,1992,15.2,11,7,2,9,0,4,17,23.5,13,14,6,8,21,32,9,0
391,Daniel Parejo,ESP,MF,Valencia,29,1989,34.0,73,42,41,24,8,31,90,34.4,59,41,7,34,46,119,26,2
392,Thomas Partey,GHA,MF,Atlético Madrid,25,1993,23.0,66,42,32,25,9,21,49,42.9,28,26,5,21,49,115,22,2
393,Gabriel Paulista,BRA,DF,Valencia,27,1990,29.1,29,16,20,6,3,14,28,50.0,14,37,21,16,70,99,162,1
394,Alfonso Pedraza,ESP,DF|FW,Villarreal,22,1996,23.3,59,44,34,19,6,22,62,35.5,40,33,7,26,29,88,55,0
395,Adrià Pedrosa,ESP,DF,Espanyol,20,1998,8.5,14,9,11,2,1,7,14,50.0,7,10,4,6,8,22,27,0
396,Rubén Peña,ESP,DF,Eibar,27,1991,29.7,63,46,24,27,12,24,53,45.3,29,37,9,28,35,98,57,0
397,Carles Pérez,ESP,FW,Barcelona,20,1998,0.2,0,0,0,0,0,0,0,,0,1,0,1,0,0,0,0
398,Hernán Pérez,PAR,FW|MF,Espanyol,29,1989,8.8,13,10,8,3,2,6,27,22.2,21,14,3,11,5,18,13,0
399,Rubén Pérez,ESP,MF,Leganés,29,1989,27.5,71,42,27,40,4,32,80,40.0,48,35,8,27,40,111,34,1
400,Pablo Piatti,ARG,FW|MF,Espanyol,29,1989,8.3,21,15,8,10,3,8,16,50.0,8,15,0,15,2,23,8,0
401,Cristiano Piccini,ITA,DF,Valencia,25,1992,20.8,32,23,25,7,0,13,26,50.0,13,27,7,20,27,59,64,1
402,Tomás Pina Isla,ESP,MF,Alavés,30,1987,26.0,64,41,23,36,5,18,46,39.1,28,15,4,11,41,105,43,1
403,Gerard Piqué,ESP,DF,Barcelona,31,1987,35.0,42,27,25,17,0,24,37,64.9,13,41,27,14,36,78,154,5
404,Carles Planas,ESP,DF,Girona,27,1991,4.7,12,6,7,5,0,4,11,36.4,7,2,0,2,4,16,15,0
405,Óscar Plano,ESP,MF|FW,Valladolid,27,1991,29.9,63,45,23,28,12,14,48,29.2,34,19,3,16,22,85,28,1
406,Stiven Plaza,ECU,FW|MF,Valladolid,19,1999,0.4,0,0,0,0,0,0,0,,0,0,0,0,0,0,0,0
407,Pere Pons,ESP,MF,Girona,25,1993,31.0,83,46,34,38,11,30,82,36.6,52,48,12,36,35,118,39,0
408,Pedro Porro,ESP,DF,Girona,18,1999,24.6,51,31,28,16,7,32,80,40.0,48,36,2,34,39,90,60,1
409,Francisco Portillo,ESP,MF,Getafe,28,1990,22.2,26,16,6,15,5,9,29,31.0,20,14,0,14,17,43,9,0
410,Portu,ESP,FW|MF,Girona,26,1992,31.3,33,24,8,15,10,12,43,27.9,31,16,1,15,8,41,5,0
411,Sergio Postigo,ESP,DF,Levante,29,1988,16.1,25,15,22,3,0,15,19,78.9,4,21,12,9,20,45,77,0
412,José Pozo,ESP,MF,Rayo Vallecano,22,1996,18.0,13,10,4,5,4,4,25,16.0,21,7,1,6,4,17,6,0
413,Sanjin Prcić,BIH,MF,Levante,24,1993,5.9,18,13,7,9,2,5,11,45.5,6,11,7,4,11,29,11,1
414,Quincy Promes,NED,FW|DF,Sevilla,26,1992,17.6,35,25,23,9,3,15,22,68.2,7,19,3,16,25,60,22,1
415,Javi Puado,ESP,FW|MF,Espanyol,20,1998,4.0,2,1,0,2,0,0,7,0.0,7,5,1,4,6,8,4,0
416,Riqui Puig,ESP,MF,Barcelona,18,1999,1.7,3,3,0,2,1,2,3,66.7,1,0,0,0,0,3,1,0
417,Jorge Pulido,ESP,DF,Huesca,27,1991,30.9,63,42,40,19,4,32,51,62.7,19,39,18,21,50,113,158,0
418,Xavi Quintillà,ESP,DF,Villarreal,21,1996,7.0,10,4,5,4,1,6,12,50.0,6,5,2,3,8,18,17,0
419,Dani Raba,ESP,MF|FW,Villarreal,22,1995,2.1,6,5,1,2,3,1,5,20.0,4,1,0,1,1,7,0,0
420,Rafinha,BRA,FW|MF,Barcelona,25,1993,2.5,8,6,2,3,3,2,2,100.0,0,5,1,4,1,9,2,0
421,Ivan Rakitić,CRO,MF,Barcelona,30,1988,29.4,30,24,10,14,6,12,37,32.4,25,32,8,24,51,81,33,0
422,Jonás Ramalho,ESP,DF,Girona,25,1993,18.0,13,6,12,1,0,8,14,57.1,6,24,11,13,16,29,80,1
423,Sandro Ramírez,ESP,FW|MF,Real Sociedad,23,1995,11.7,19,10,7,10,2,4,11,36.4,7,12,1,11,9,28,3,0
424,Iván Ramis,ESP,DF,Eibar,33,1984,18.6,23,13,10,11,2,17,23,73.9,6,10,5,5,18,41,65,2
425,Chris Ramos,ESP,FW,Valladolid,21,1997,0.7,1,1,0,0,1,1,1,100.0,0,0,0,0,0,1,1,0
426,Sergio Ramos,ESP,DF,Real Madrid,32,1986,27.5,41,32,25,12,4,22,39,56.4,17,29,15,14,37,78,90,2
427,Recio,ESP,MF,Leganés,27,1991,14.3,30,21,14,13,3,6,24,25.0,18,14,2,12,14,44,14,0
428,Sergio Reguilón,ESP,DF,Real Madrid,21,1996,12.4,25,14,15,9,1,10,21,47.6,11,13,3,10,20,45,41,1
429,Diego Reyes,MEX,DF,Leganés,25,1992,3.6,7,4,4,3,0,3,4,75.0,1,4,4,0,7,14,17,1
430,Mikel Rico,ESP,MF,Athletic Club,33,1984,2.7,5,2,1,4,0,2,7,28.6,5,3,2,1,2,7,3,0
431,Asier Riesgo,ESP,GK,Eibar,34,1983,14.0,1,1,1,0,0,1,3,33.3,2,0,0,0,0,1,8,1
432,Cristian Rivera,ESP,MF,Huesca,21,1997,18.8,38,25,18,19,1,11,25,44.0,14,21,4,17,31,69,31,0
433,Rober,ESP,DF,Levante,23,1995,31.7,41,29,33,6,2,24,48,50.0,24,52,36,16,51,92,129,2
434,Sergi Roberto,ESP,DF|MF,Barcelona,26,1992,23.2,28,20,15,9,4,16,24,66.7,8,18,3,15,43,71,31,0
435,Patrick Roberts,ENG,MF|FW,Girona,21,1997,6.7,7,6,5,2,0,3,15,20.0,12,5,0,5,3,10,2,1
436,Joel Robles,ESP,GK,Betis,28,1990,5.0,1,0,1,0,0,1,1,100.0,0,0,0,0,0,1,5,1
437,Marc Roca,ESP,MF,Espanyol,21,1996,34.6,71,45,36,26,9,28,70,40.0,42,43,21,22,36,107,60,3
438,Rubén Rochina,ESP,MF,Levante,27,1991,20.0,51,33,26,16,9,23,81,28.4,58,29,0,29,21,72,19,1
439,Rodri,ESP,MF,Atlético Madrid,22,1996,30.4,103,70,45,50,8,39,75,52.0,36,35,11,24,41,144,68,0
440,Rodrigo,ESP,FW,Valencia,27,1991,28.1,21,10,6,9,6,3,17,17.6,14,17,1,16,3,24,18,0
441,Kévin Rodrigues,POR,DF,Real Sociedad,24,1994,5.4,21,11,14,6,1,9,17,52.9,8,13,3,10,8,29,15,0
442,Ángel Rodríguez,ESP,FW,Getafe,31,1987,20.2,16,7,1,6,9,6,26,23.1,20,15,1,14,8,24,8,0
443,Óscar Rodríguez Arnaiz,ESP,MF,Leganés,20,1998,27.8,46,25,26,15,5,16,58,27.6,42,12,2,10,16,62,16,0
444,Marko Rog,CRO,MF,Sevilla,23,1995,4.0,12,11,4,8,0,5,9,55.6,4,4,0,4,8,20,1,0
445,Diego Rolán,URU,MF|FW,Leganés,25,1993,2.4,6,4,3,3,0,2,9,22.2,7,2,0,2,3,9,3,0
446,Diego Rolán,URU,MF|FW,Alavés,25,1993,3.3,7,4,3,1,3,0,2,0.0,2,1,0,1,1,8,4,0
447,Facundo Roncaglia,ARG,DF,Valencia,31,1987,6.7,13,10,8,5,0,4,6,66.7,2,4,2,2,10,23,22,0
448,Facundo Roncaglia,ARG,DF,Celta Vigo,31,1987,11.9,34,22,26,8,0,17,24,70.8,7,12,5,7,20,54,51,2
449,Roberto Rosales,VEN,DF,Espanyol,29,1988,19.4,48,31,22,16,10,21,44,47.7,23,19,7,12,22,70,68,0
450,Waldo Rubio,ESP,MF,Valladolid,22,1995,5.5,4,2,3,1,0,1,6,16.7,5,2,0,2,1,5,8,1
451,Abel Ruiz,ESP,FW,Barcelona,18,2000,0.2,1,1,1,0,0,1,1,100.0,0,0,0,0,0,1,0,0
452,Víctor Ruiz,ESP,DF,Villarreal,29,1989,21.9,28,19,20,6,2,13,18,72.2,5,28,16,12,38,66,67,1
453,Gerónimo Rulli,ARG,GK,Real Sociedad,26,1992,27.0,2,1,2,0,0,1,3,33.3,2,1,0,1,1,3,12,6
454,Samuel Sáiz,ESP,MF,Getafe,27,1991,3.4,4,3,0,3,1,2,5,40.0,3,1,0,1,0,4,2,0
455,Mikel San José,ESP,MF,Athletic Club,29,1989,19.3,43,25,19,19,5,15,48,31.3,33,27,6,21,21,64,35,0
456,Antonio Sanabria,PAR,FW,Betis,22,1996,9.0,8,6,0,5,3,1,6,16.7,5,8,2,6,3,11,4,0
457,Javi Sánchez,ESP,DF,Real Madrid,21,1997,0.5,1,0,1,0,0,0,0,,0,0,0,0,0,1,4,0
458,Víctor Sánchez,ESP,MF,Espanyol,30,1987,14.1,45,30,21,17,7,14,67,20.9,53,17,2,15,25,70,25,0
459,Luca Sangalli,ESP,MF|FW,Real Sociedad,23,1995,11.1,19,13,6,11,2,5,22,22.7,17,9,1,8,5,24,5,0
460,Nicola Sansone,ITA,FW|MF,Villarreal,26,1991,0.4,0,0,0,0,0,0,0,,0,0,0,0,0,0,0,0
461,Roberto Santamaría,ESP,GK,Huesca,33,1985,20.0,0,0,0,0,0,0,0,,0,0,0,0,1,1,12,1
462,Michael Santos,URU,FW|MF,Leganés,25,1993,6.2,12,5,1,7,4,2,7,28.6,5,7,1,6,1,13,1,0
463,Pablo Sarabia,ESP,MF|FW,Sevilla,26,1992,30.3,30,15,6,15,9,6,47,12.8,41,30,3,27,22,52,20,0
464,Lluís Sastre,ESP,MF,Huesca,32,1986,1.3,5,3,0,5,0,0,1,0.0,1,0,0,0,1,6,0,0
465,Stefan Savić,MNE,DF,Atlético Madrid,27,1991,15.5,11,10,9,2,0,7,12,58.3,5,13,9,4,22,33,67,0
466,Alfa Semedo,GNB,MF,Espanyol,20,1997,0.5,0,0,0,0,0,0,3,0.0,3,1,1,0,2,2,0,0
467,Nélson Semedo,POR,DF,Barcelona,24,1993,17.8,38,27,23,12,3,12,18,66.7,6,23,7,16,22,60,26,0
468,Rúben Semedo,POR,DF,Huesca,24,1994,9.4,20,16,14,6,0,12,16,75.0,4,15,9,6,16,36,35,2
469,Paik Seung-ho,KOR,FW|MF,Girona,21,1997,0.7,0,0,0,0,0,0,1,0.0,1,1,0,1,3,3,1,0
470,Gaku Shibasaki,JPN,MF|FW,Getafe,26,1992,4.3,7,3,2,4,1,3,6,50.0,3,2,0,2,3,10,4,0
471,Sidnei,BRA,DF,Betis,28,1989,19.4,48,29,33,12,3,18,34,52.9,16,21,8,13,41,89,57,0
472,André Silva,POR,FW,Sevilla,22,1995,24.0,8,5,1,4,3,1,11,9.1,10,17,1,16,3,11,32,0
473,Jonathan Silva,ARG,DF|FW,Leganés,24,1994,30.0,51,38,30,17,4,23,52,44.2,29,23,2,21,29,80,86,0
474,Moses Simon,NGA,DF|MF,Levante,23,1995,8.7,14,8,10,2,2,5,9,55.6,4,10,1,9,12,26,14,0
475,Unai Simón,ESP,GK,Athletic Club,21,1997,7.0,0,0,0,0,0,0,1,0.0,1,0,0,0,1,1,1,1
476,Dimitris Siovas,GRE,DF,Leganés,29,1988,32.9,57,32,38,18,1,27,47,57.4,20,32,15,17,65,122,155,1
477,Pione Sisto,DEN,FW|MF,Celta Vigo,23,1995,9.4,4,3,4,0,0,0,9,0.0,9,5,0,5,3,7,3,0
478,Antonio Sivera,ESP,GK,Alavés,21,1996,3.0,0,0,0,0,0,0,0,,0,0,0,0,0,0,4,1
479,Rubén Sobrino,ESP,FW|MF,Alavés,26,1992,10.7,16,11,7,6,3,5,13,38.5,8,16,1,15,2,18,13,0
480,Rubén Sobrino,ESP,FW|MF,Valencia,26,1992,2.1,6,3,1,4,1,1,1,100.0,0,1,1,0,1,7,1,0
481,Alex Sola,ESP,DF,Real Sociedad,19,1999,1.0,4,3,0,3,1,3,4,75.0,1,0,0,0,1,5,2,0
482,Andrés Solano,COL,DF,Atlético Madrid,20,1998,0.5,4,3,2,2,0,2,2,100.0,0,1,0,1,0,4,1,0
483,Carlos Soler,ESP,MF,Valencia,21,1997,27.3,41,28,15,23,3,16,65,24.6,49,46,6,40,19,60,37,0
484,Kévin Soni,CMR,FW|DF,Girona,20,1998,0.9,3,2,0,2,1,2,4,50.0,2,3,0,3,1,4,0,0
485,David Soria,ESP,GK,Getafe,25,1993,37.0,1,0,1,0,0,1,2,50.0,1,2,0,2,1,2,15,6
486,Juan Soriano,ESP,GK,Sevilla,20,1997,4.0,0,0,0,0,0,0,0,,0,0,0,0,1,1,1,0
487,Cristhian Stuani,URU,FW,Girona,31,1986,30.3,23,13,7,13,3,5,20,25.0,15,13,1,12,4,27,39,0
488,Damián Suárez,URU,DF,Getafe,30,1988,36.0,96,62,43,41,12,53,120,44.2,67,47,6,41,46,142,57,2
489,Denis Suárez,ESP,MF|DF,Barcelona,24,1994,0.2,0,0,0,0,0,0,0,,0,1,0,1,0,0,0,0
490,Leonardo Suárez,ARG,FW|MF,Valladolid,22,1996,5.7,3,3,2,0,1,2,4,50.0,2,7,1,6,1,4,4,0
491,Luis Suárez,URU,FW,Barcelona,31,1987,31.4,18,11,1,6,11,4,10,40.0,6,12,4,8,8,26,24,0
492,Mario Suárez,ESP,MF,Rayo Vallecano,31,1987,11.4,37,23,17,17,3,15,28,53.6,13,10,3,7,14,51,17,2
493,Markel Susaeta,ESP,FW|MF,Athletic Club,30,1987,15.3,17,10,4,6,7,3,23,13.0,20,10,1,9,12,29,5,0
494,Rodrigo Tarín,ESP,DF,Leganés,22,1996,15.9,22,14,15,5,2,7,10,70.0,3,11,5,6,31,53,79,0
495,Cristian Tello,ESP,DF|FW,Betis,26,1991,17.5,32,20,18,9,5,17,35,48.6,18,19,0,19,16,48,17,1
496,Marc-André ter Stegen,GER,GK,Barcelona,26,1992,35.0,0,0,0,0,0,0,3,0.0,3,0,0,0,2,2,5,2
497,David Timor,ESP,MF,Girona,28,1989,1.8,2,2,1,1,0,0,1,0.0,1,1,1,0,3,5,3,0
498,Tito,ESP,DF,Rayo Vallecano,33,1985,12.2,14,9,12,2,0,7,22,31.8,15,22,2,20,17,31,41,0
499,Jean-Clair Todibo,FRA,DF,Barcelona,18,1999,1.7,7,2,4,3,0,5,6,83.3,1,1,0,1,3,10,8,0
500,Karl Toko Ekambi,CMR,FW|MF,Villarreal,25,1992,23.8,11,8,1,6,4,2,14,14.3,12,8,0,8,11,22,9,1
501,Raúl de Tomás,ESP,FW,Rayo Vallecano,23,1994,31.3,8,3,0,7,1,0,12,0.0,12,18,4,14,9,17,45,0
502,Toño,ESP,DF|FW,Levante,28,1989,19.6,17,13,12,3,2,10,21,47.6,11,20,5,15,14,31,42,0
503,Daniel Torres,COL,MF,Alavés,28,1989,0.8,2,1,2,0,0,0,3,0.0,3,0,0,0,2,4,0,0
504,Ferrán Torres,ESP,MF,Valencia,18,2000,9.4,15,8,4,8,3,5,11,45.5,6,10,1,9,10,25,9,0
505,Óscar Trejo,ARG,MF|FW,Rayo Vallecano,30,1988,19.6,57,41,21,25,11,8,33,24.2,25,24,2,22,18,75,15,0
506,Manu Trigueros,ESP,MF,Villarreal,26,1991,17.2,46,35,18,23,5,20,57,35.1,37,17,6,11,16,62,17,0
507,Patrick Twumasi,GHA,MF|FW,Alavés,24,1994,1.9,3,3,2,0,1,0,4,0.0,4,2,0,2,1,4,1,0
508,Samuel Umtiti,FRA,DF,Barcelona,24,1993,13.2,8,5,3,4,1,4,6,66.7,2,10,8,2,18,26,28,2
509,Enes Ünal,TUR,FW,Valladolid,21,1997,23.9,17,10,3,4,10,4,24,16.7,20,17,4,13,2,19,18,0
510,Tomáš Vaclík,CZE,GK,Sevilla,29,1989,33.0,0,0,0,0,0,0,1,0.0,1,0,0,0,0,0,9,6
511,Jesús Vallejo,ESP,DF,Real Madrid,21,1997,3.5,6,5,4,2,0,5,6,83.3,1,4,4,0,7,13,12,0
512,Federico Valverde,URU,MF,Real Madrid,20,1998,7.3,12,8,3,7,2,5,11,45.5,6,10,2,8,21,33,10,0
513,Raphaël Varane,FRA,DF,Real Madrid,25,1993,30.6,33,18,25,7,1,15,19,78.9,4,21,9,12,32,65,141,1
514,Franco Vázquez,ARG,MF,Sevilla,29,1989,25.3,51,37,21,21,9,23,66,34.8,43,25,2,23,23,74,27,1
515,Kevin Vázquez,ESP,DF,Celta Vigo,25,1993,2.4,6,5,5,0,1,4,7,57.1,3,8,3,5,2,8,9,0
516,Lucas Vázquez,ESP,FW|MF,Real Madrid,27,1991,16.8,43,26,11,21,11,15,41,36.6,26,16,1,15,12,55,11,0
517,Koke Vegas,ESP,GK,Levante,22,1995,1.0,0,0,0,0,0,0,0,,0,0,0,0,0,0,0,0
518,Emiliano Velázquez,URU,DF,Rayo Vallecano,24,1994,14.2,49,32,38,9,2,20,34,58.8,14,29,7,22,47,96,106,1
519,Daniele Verde,ITA,MF|FW,Valladolid,22,1996,7.3,6,3,2,2,2,1,6,16.7,5,3,0,3,7,13,3,1
520,Thomas Vermaelen,BEL,DF,Barcelona,32,1985,6.5,6,4,3,3,0,3,7,42.9,4,4,2,2,6,12,21,0
521,Mikel Vesga,ESP,MF,Leganés,25,1993,23.0,50,32,27,15,8,20,82,24.4,62,42,4,38,39,89,26,0
522,Rúben Vezo,POR,DF,Levante,24,1994,14.9,26,17,17,8,1,14,22,63.6,8,23,20,3,19,45,88,0
523,Rúben Vezo,POR,DF,Valencia,24,1994,2.2,2,1,2,0,0,2,4,50.0,2,2,1,1,2,4,10,0
524,Aleix Vidal,ESP,DF|MF,Sevilla,28,1989,5.9,13,11,5,5,3,5,14,35.7,9,5,0,5,4,17,12,0
525,Arturo Vidal,CHI,MF,Barcelona,31,1987,21.4,78,44,32,37,9,30,69,43.5,39,46,5,41,29,107,23,1
526,Carlos Vigaray,ESP,DF,Alavés,23,1994,7.2,15,8,10,4,1,9,15,60.0,6,6,1,5,6,21,24,1
527,Dídac Vilà,ESP,DF,Espanyol,29,1989,26.2,67,31,33,26,8,31,58,53.4,27,41,12,29,53,120,94,1
528,Toni Villa,ESP,MF|FW,Valladolid,23,1995,19.6,51,32,24,18,9,20,47,42.6,27,15,0,15,12,63,10,0
529,Vitolo,ESP,MF|FW,Atlético Madrid,28,1989,8.4,17,13,8,6,3,6,19,31.6,13,8,1,7,10,27,6,0
530,Nikola Vukčević,MNE,MF,Levante,26,1991,7.4,25,18,12,9,4,9,24,37.5,15,15,5,10,10,35,17,0
531,Moussa Wagué,SEN,DF|FW,Barcelona,19,1998,2.5,6,5,1,4,1,3,7,42.9,4,1,0,1,4,10,3,0
532,Wakaso,GHA,MF,Alavés,28,1990,18.5,46,30,23,19,4,12,36,33.3,24,37,9,28,16,62,19,2
533,Daniel Wass,DEN,DF|MF,Valencia,29,1989,26.2,35,25,9,19,7,20,42,47.6,22,23,4,19,34,69,49,0
534,Axel Werner,ARG,GK,Huesca,22,1996,6.0,0,0,0,0,0,0,0,,0,0,0,0,0,0,2,0
535,Iñaki Williams,GHA,FW,Athletic Club,24,1994,33.6,27,18,9,7,11,5,22,22.7,17,22,1,21,7,34,33,0
536,Maximilian Wöber,AUT,DF,Sevilla,20,1998,6.0,12,9,8,2,2,3,6,50.0,3,6,0,6,7,19,16,0
537,Yoel,ESP,GK,Valladolid,29,1988,3.0,0,0,0,0,0,0,0,,0,0,0,0,0,0,0,1
538,Okay Yokuşlu,TUR,MF,Celta Vigo,24,1994,24.4,61,39,31,28,2,28,45,62.2,17,32,11,21,37,98,53,2
539,Joseba Zaldúa,ESP,DF,Real Sociedad,26,1992,23.8,36,27,23,10,3,15,32,46.9,17,19,3,16,38,74,72,0
540,Nabil El Zhar,MAR,MF|FW,Leganés,31,1986,10.7,8,4,2,4,2,0,5,0.0,5,4,0,4,4,12,1,0
541,Luca Zidane,FRA,GK,Real Madrid,20,1998,1.0,0,0,0,0,0,0,0,,0,0,0,0,0,0,0,0
542,Igor Zubeldia,ESP,MF,Real Sociedad,21,1997,28.3,61,35,32,24,5,22,54,40.7,32,30,6,24,45,106,60,0
543,Martín Zubimendi,ESP,MF,Real Sociedad,19,1999,0.1,1,0,0,1,0,0,1,0.0,1,0,0,0,0,1,0,0
544,David Zurutuza,ESP,MF,Real Sociedad,32,1986,13.6,27,16,9,15,3,8,22,36.4,14,19,4,15,24,51,26,1
