Rk,Player,Nation,Pos,Squad,Age,Born,90s,Tackles Tkl,Tackles TklW,Tackles Def 3rd,Tackles Mid 3rd,Tackles Att 3rd,Challenges Tkl,Challenges Att,Challenges Tkl%,Challenges Lost,Blocks Blocks,Blocks Sh,Blocks Pass,Int,Tkl+Int,Clr,Err
1,Tammy Abraham,ENG,FW,Roma,23,1997,34.3,27,13,7,14,6,9,22,40.9,13,17,3,14,5,32,27,0
2,Francesco Acerbi,ITA,DF,Lazio,33,1988,28.2,25,12,15,9,1,12,19,63.2,7,37,28,9,34,59,92,0
3,Michel Aebischer,SUI,MF,Bologna,24,1997,4.9,14,5,5,8,1,6,11,54.5,5,4,1,3,6,20,3,0
4,Felix Afena-Gyan,GHA,FW|MF,Roma,18,2003,7.4,10,3,1,6,3,4,7,57.1,3,4,0,4,3,13,0,0
5,Kevin Agudelo,COL,MF|FW,Spezia,22,1998,13.7,44,26,13,26,5,7,20,35.0,13,22,0,22,8,52,6,0
6,Ola Aina,NGA,DF,Torino,24,1996,16.0,27,19,11,10,6,15,23,65.2,8,17,3,14,28,55,30,0
7,Marley Aké,FRA,FW|MF,Juventus,20,2001,0.9,0,0,0,0,0,0,2,0.0,2,0,0,0,1,1,0,0
8,Jean-Daniel Akpa-Akpro,CIV,MF,Lazio,28,1992,3.5,17,10,7,9,1,7,12,58.3,5,4,2,2,2,19,6,0
9,Luis Alberto,ESP,MF,Lazio,28,1992,26.1,29,17,8,11,10,8,52,15.4,44,32,4,28,13,42,7,0
10,Giorgio Altare,ITA,DF,Cagliari,22,1998,16.3,39,28,18,18,3,21,26,80.8,5,17,5,12,30,69,70,0
11,Wisdom Amey,ITA,DF,Bologna,15,2005,0.8,3,2,1,1,1,2,3,66.7,1,2,0,2,3,6,1,0
12,Kelvin Amian,FRA,DF,Spezia,23,1998,29.4,66,42,43,18,5,30,41,73.2,11,39,21,18,32,98,75,0
13,Nadiem Amiri,GER,MF|FW,Genoa,24,1996,7.6,6,4,2,2,2,2,9,22.2,7,7,0,7,0,6,0,0
14,Ethan Ampadu,WAL,MF|DF,Venezia,20,2000,25.4,67,43,37,27,3,24,58,41.4,34,49,19,30,51,118,76,0
15,Sofyan Amrabat,MAR,MF,Fiorentina,24,1996,10.5,24,13,9,13,2,11,19,57.9,8,25,8,17,5,29,6,1
16,Felipe Anderson,BRA,FW,Lazio,28,1993,32.1,71,45,30,33,8,27,99,27.3,72,65,6,59,20,91,16,0
17,Ebenezer Annan,GHA,DF,Bologna,18,2002,0.3,1,1,1,0,0,0,0,,0,0,0,0,1,2,1,0
18,Cristian Ansaldi,ARG,DF,Torino,34,1986,7.7,20,9,11,7,2,10,13,76.9,3,9,1,8,6,26,10,0
19,Janis Antiste,FRA,FW,Spezia,18,2002,8.8,18,11,6,6,6,5,13,38.5,8,7,1,6,4,22,6,0
20,Mattia Aramu,ITA,MF|FW,Venezia,26,1995,23.3,20,15,5,9,6,8,33,24.2,25,20,2,18,8,28,19,0
21,Marko Arnautović,AUT,FW,Bologna,32,1989,29.9,17,9,1,11,5,7,30,23.3,23,13,2,11,7,24,17,0
22,Tolgay Arslan,GER,MF,Udinese,30,1990,18.4,35,20,15,16,4,19,50,38.0,31,17,4,13,13,48,23,1
23,Arthur,BRA,FW,Fiorentina,23,1998,8.3,9,5,2,5,2,4,7,57.1,3,4,1,3,1,10,8,0
24,Kristoffer Askildsen,NOR,MF,Sampdoria,20,2001,8.4,18,6,7,11,0,9,19,47.4,10,14,7,7,15,33,15,0
25,Kristjan Asllani,ALB,MF,Empoli,19,2002,15.0,18,9,9,8,1,11,29,37.9,18,16,7,9,19,37,15,1
26,Emil Audero,ITA,GK,Sampdoria,24,1997,28.4,3,1,3,0,0,3,5,60.0,2,0,0,0,2,5,17,2
27,Tommaso Augello,ITA,DF,Sampdoria,26,1994,26.6,36,20,22,8,6,17,29,58.6,12,19,4,15,29,65,68,1
28,Ramzi Aya,ITA,DF,Salernitana,30,1990,1.5,1,1,1,0,0,1,1,100.0,0,0,0,0,0,1,4,0
29,Kaan Ayhan,TUR,DF,Sassuolo,26,1994,15.0,20,12,14,6,0,7,15,46.7,8,20,14,6,13,33,57,0
30,Milan Badelj,CRO,MF,Genoa,32,1989,31.6,64,37,25,30,9,34,80,42.5,46,39,7,32,85,149,43,0
31,Nicola Bagnolini,ITA,GK,Bologna,17,2004,0.0,0,0,0,0,0,0,0,,0,0,0,0,0,0,0,0
32,Issa Bah,LUX,FW,Venezia,19,2002,0.1,0,0,0,0,0,0,0,,0,0,0,0,0,0,0,0
33,Nedim Bajrami,ALB,MF|FW,Empoli,22,1999,22.8,21,14,5,13,3,4,14,28.6,10,11,0,11,3,24,8,0
34,Tiemoué Bakayoko,FRA,MF,Milan,26,1994,5.6,19,13,9,7,3,5,16,31.3,11,8,1,7,9,28,10,2
35,Tommaso Baldanzi,ITA,FW,Empoli,18,2003,0.2,0,0,0,0,0,0,0,,0,1,0,1,0,0,0,0
36,Keita Baldé,SEN,FW,Cagliari,26,1995,13.7,8,4,1,5,2,1,10,10.0,9,6,0,6,4,12,6,0
37,Fodé Ballo-Touré,SEN,DF,Milan,24,1997,5.0,18,14,5,13,0,4,9,44.4,5,6,2,4,3,21,5,0
38,Filippo Bandinelli,ITA,MF,Empoli,26,1995,21.7,33,20,10,17,6,15,31,48.4,16,22,5,17,10,43,37,2
39,Mattia Bani,ITA,DF,Genoa,27,1993,13.5,23,13,17,6,0,14,18,77.8,4,19,11,8,20,43,76,0
40,Antonín Barák,CZE,MF|FW,Hellas Verona,26,1994,26.0,18,8,9,8,1,5,17,29.4,12,32,5,27,6,24,26,0
41,Francesco Bardi,ITA,GK,Bologna,29,1992,2.0,0,0,0,0,0,0,0,,0,0,0,0,0,0,0,0
42,Nicolò Barella,ITA,MF,Inter,24,1997,32.4,63,42,17,35,11,29,55,52.7,26,26,2,24,21,84,8,2
43,Musa Barrow,GAM,FW|MF,Bologna,22,1998,23.7,12,4,4,4,4,6,20,30.0,14,20,1,19,6,18,8,0
44,Daniele Baselli,ITA,MF|FW,Torino,29,1992,1.7,3,3,2,0,1,2,6,33.3,4,0,0,0,1,4,2,0
45,Daniele Baselli,ITA,MF,Cagliari,29,1992,3.2,6,5,3,1,2,1,5,20.0,4,2,0,2,2,8,5,0
46,Toma Bašić,CRO,MF,Lazio,24,1996,10.9,12,8,3,9,0,5,17,29.4,12,13,4,9,4,16,21,0
47,Alessandro Bastoni,ITA,DF,Inter,22,1999,25.7,44,25,28,13,3,17,34,50.0,17,22,12,10,35,79,59,1
48,Simone Bastoni,ITA,MF|DF,Spezia,24,1996,25.4,52,34,28,17,7,21,65,32.3,44,38,11,27,30,82,31,0
49,Rodrigo Becão,BRA,DF,Udinese,25,1996,34.8,81,46,49,30,2,34,60,56.7,26,45,20,25,42,123,89,3
50,Valon Behrami,SUI,MF|FW,Genoa,36,1985,3.5,3,1,0,2,1,0,7,0.0,7,4,1,3,1,4,4,0
51,Vid Belec,SVN,GK,Salernitana,31,1990,21.5,0,0,0,0,0,0,0,,0,0,0,0,0,0,9,1
52,Raoul Bellanova,ITA,DF|FW,Cagliari,21,2000,27.7,29,15,14,12,3,6,27,22.2,21,39,8,31,21,50,51,0
53,Andrea Belotti,ITA,FW,Torino,27,1993,15.2,7,3,2,2,3,3,12,25.0,9,12,4,8,2,9,9,0
54,Marco Benassi,ITA,DF|MF,Fiorentina,26,1994,1.8,1,0,1,0,0,1,2,50.0,1,3,0,3,3,4,3,0
55,Marco Benassi,ITA,MF,Empoli,26,1994,4.2,6,3,3,2,1,1,10,10.0,9,4,0,4,3,9,6,0
56,Filip Benković,CRO,DF|FW,Udinese,24,1997,0.1,0,0,0,0,0,0,0,,0,0,0,0,0,0,0,0
57,Ismaël Bennacer,ALG,MF,Milan,23,1997,16.9,44,30,22,15,7,21,50,42.0,29,20,4,16,25,69,15,0
58,Rodrigo Bentancur,URU,MF,Juventus,24,1997,12.8,32,18,11,18,3,7,20,35.0,13,15,2,13,26,58,15,1
59,Alessandro Berardi,ITA,GK,Hellas Verona,30,1991,1.0,0,0,0,0,0,0,0,,0,0,0,0,0,0,0,0
60,Domenico Berardi,ITA,FW,Sassuolo,26,1994,31.3,32,19,9,16,7,15,57,26.3,42,39,2,37,31,63,23,0
61,Bartosz Bereszyński,POL,DF,Sampdoria,29,1992,32.7,64,38,34,25,5,37,80,46.3,43,38,12,26,42,106,73,1
62,Etrit Berisha,ALB,GK,Torino,32,1989,10.0,0,0,0,0,0,0,0,,0,0,0,0,0,0,4,0
63,Federico Bernardeschi,ITA,MF|FW,Juventus,27,1994,16.4,16,10,7,4,5,6,13,46.2,7,12,4,8,5,21,15,0
64,Nicolò Bertola,ITA,MF|DF,Spezia,18,2003,0.4,3,2,3,0,0,3,4,75.0,1,0,0,0,3,6,1,0
65,Daniel Bessa,ITA,MF,Hellas Verona,28,1993,8.5,7,2,3,3,1,4,15,26.7,11,13,3,10,5,12,11,0
66,Beto,GNB,FW,Udinese,23,1998,24.1,21,6,2,14,5,9,19,47.4,10,16,1,15,5,26,25,1
67,Luis Binks,ENG,DF,Bologna,19,2001,7.2,8,4,7,1,0,4,6,66.7,2,6,5,1,17,25,33,1
68,Cristiano Biraghi,ITA,DF,Fiorentina,28,1992,35.0,37,24,17,15,5,22,53,41.5,31,28,10,18,19,56,31,1
69,Davide Biraschi,ITA,DF,Genoa,27,1994,10.3,31,16,19,9,3,17,24,70.8,7,16,9,7,16,47,26,0
70,Bjarki Bjarkason,ISL,MF,Venezia,21,2000,0.0,0,0,0,0,0,0,0,,0,0,0,0,0,0,0,0
71,Jeremie Boga,CIV,FW|MF,Atalanta,24,1997,8.5,7,3,0,4,3,4,6,66.7,2,6,0,6,1,8,3,1
72,Jeremie Boga,CIV,FW|MF,Sassuolo,24,1997,7.4,7,4,1,2,4,2,3,66.7,1,3,0,3,2,9,1,1
73,Luka Bogdan,CRO,DF,Salernitana,25,1996,4.4,6,3,6,0,0,4,8,50.0,4,3,2,1,6,12,21,0
74,Emil Bohinen,NOR,MF,Salernitana,22,1999,7.8,15,9,4,9,2,10,20,50.0,10,17,3,14,12,27,14,0
75,Giacomo Bonaventura,ITA,MF,Fiorentina,31,1989,25.2,33,17,12,16,5,21,46,45.7,25,20,2,18,14,47,9,1
76,Federico Bonazzoli,ITA,FW|MF,Salernitana,24,1997,20.7,24,12,9,8,7,6,25,24.0,19,17,1,16,6,30,7,0
77,Kevin Bonifazi,ITA,DF,Bologna,25,1996,13.4,25,16,16,7,2,13,14,92.9,1,22,7,15,16,41,35,0
78,Leonardo Bonucci,ITA,DF,Juventus,34,1987,22.3,14,5,4,10,0,8,13,61.5,5,22,17,5,26,40,82,0
79,Mehdi Bourabia,MAR,MF,Spezia,29,1991,3.1,5,1,2,3,0,3,11,27.3,8,7,6,1,3,8,10,0
80,Edoardo Bove,ITA,MF|DF,Roma,19,2002,0.8,1,1,1,0,0,0,2,0.0,2,1,0,1,1,2,0,0
81,Josip Brekalo,CRO,MF,Torino,23,1998,25.4,9,5,5,1,3,3,21,14.3,18,16,1,15,4,13,7,1
82,Gleison Bremer,BRA,DF,Torino,24,1997,32.1,49,24,27,22,0,18,28,64.3,10,54,23,31,105,154,137,0
83,Marcelo Brozović,CRO,MF,Inter,28,1992,32.6,77,45,34,35,8,34,68,50.0,34,28,10,18,37,114,36,2
84,Aleksander Buksa,POL,FW,Genoa,18,2003,0.7,0,0,0,0,0,0,1,0.0,1,0,0,0,0,0,1,0
85,Alessandro Buongiorno,ITA,DF,Torino,22,1999,13.1,20,9,9,8,3,9,13,69.2,4,12,6,6,31,51,44,0
86,Gianluca Busio,USA,MF,Venezia,19,2002,21.7,53,28,27,20,6,28,63,44.4,35,45,13,32,21,74,30,1
87,Jovane Cabral,CPV,FW,Lazio,23,1998,2.1,2,1,1,0,1,0,0,,0,1,1,0,1,3,1,0
88,Liberato Cacace,NZL,DF,Empoli,20,2000,5.2,15,6,8,4,3,8,8,100.0,0,7,2,5,8,23,9,0
89,Martín Cáceres,URU,DF,Cagliari,34,1987,9.2,13,7,5,5,3,4,12,33.3,8,12,3,9,14,27,21,0
90,Felipe Caicedo,ECU,FW,Genoa,32,1988,3.2,3,3,0,2,1,0,1,0.0,1,1,0,1,0,3,4,0
91,Felipe Caicedo,ECU,FW|DF,Inter,32,1988,0.3,0,0,0,0,0,0,0,,0,1,0,1,0,0,0,0
92,Davide Calabria,ITA,DF,Milan,24,1996,23.5,62,37,31,23,8,37,72,51.4,35,25,5,20,23,85,40,1
93,Riccardo Calafiori,ITA,DF,Genoa,19,2002,0.9,1,0,0,0,1,1,2,50.0,1,2,1,1,2,3,4,0
94,Riccardo Calafiori,ITA,DF,Roma,19,2002,1.9,5,4,2,2,1,1,5,20.0,4,3,0,3,3,8,1,0
95,Mattia Caldara,ITA,DF,Venezia,27,1994,30.0,48,28,30,15,3,20,34,58.8,14,49,37,12,62,110,147,1
96,Hakan Çalhanoğlu,TUR,MF,Inter,27,1994,27.6,41,23,16,19,6,11,40,27.5,29,29,5,24,25,66,12,0
97,José Callejón,ESP,FW,Fiorentina,34,1987,14.4,15,6,6,6,3,13,31,41.9,18,6,0,6,3,18,1,1
98,Andrea Cambiaso,ITA,DF,Genoa,21,2000,19.9,46,20,28,14,4,18,32,56.3,14,33,8,25,23,69,37,1
99,Matteo Cancellieri,ITA,MF|DF,Hellas Verona,19,2002,2.5,4,4,2,2,0,0,5,0.0,5,2,0,2,1,5,0,0
100,Antonio Candreva,ITA,MF|FW,Sampdoria,34,1987,34.7,27,16,9,11,7,19,55,34.5,36,23,2,21,33,60,19,0
101,Leonardo Capezzi,ITA,MF,Salernitana,26,1995,1.9,3,1,0,3,0,1,4,25.0,3,8,4,4,0,3,2,0
102,Gianluca Caprari,ITA,MF|FW,Hellas Verona,28,1993,30.4,43,25,10,22,11,17,51,33.3,34,32,0,32,4,47,7,0
103,Francesco Caputo,ITA,FW,Sampdoria,33,1987,31.0,5,2,1,3,1,1,6,16.7,5,5,0,5,2,7,10,0
104,Francesco Caputo,ITA,FW,Sassuolo,33,1987,1.7,0,0,0,0,0,0,0,,0,0,0,0,0,0,0,0
105,Andrea Carboni,ITA,DF,Cagliari,20,2001,24.6,53,24,33,16,4,19,42,45.2,23,42,15,27,27,80,87,0
106,Nicolò Casale,ITA,DF,Hellas Verona,23,1998,28.7,46,30,25,19,2,21,37,56.8,16,31,12,19,49,95,95,0
107,Francesco Cassata,ITA,MF,Genoa,24,1997,0.1,0,0,0,0,0,0,0,,0,0,0,0,0,0,0,0
108,Samu Castillejo,ESP,FW|MF,Milan,26,1995,1.4,4,2,0,2,2,1,8,12.5,7,4,1,3,2,6,1,0
109,Gaetano Castrovilli,ITA,MF,Fiorentina,24,1997,15.5,25,17,15,6,4,12,23,52.2,11,18,4,14,11,36,6,0
110,Danilo Cataldi,ITA,MF,Lazio,26,1994,19.0,36,17,15,17,4,12,38,31.6,26,24,12,12,17,53,19,1
111,Pietro Ceccaroni,ITA,DF,Venezia,25,1995,34.7,55,31,33,18,4,25,36,69.4,11,45,32,13,30,85,143,0
112,Federico Ceccherini,ITA,DF,Hellas Verona,29,1992,26.2,32,16,19,10,3,19,33,57.6,14,13,8,5,50,82,76,1
113,Emil Ceide,NOR,FW|MF,Sassuolo,19,2001,0.6,1,1,0,1,0,1,2,50.0,1,1,0,1,0,1,0,0
114,Luca Ceppitelli,ITA,DF,Cagliari,31,1989,16.1,23,12,13,10,0,16,27,59.3,11,21,14,7,25,48,54,0
115,Damir Ceter,COL,FW,Cagliari,23,1997,0.1,0,0,0,0,0,0,0,,0,0,0,0,0,0,0,0
116,Julian Chabot,GER,DF,Sampdoria,23,1998,5.4,12,10,8,4,0,8,10,80.0,2,7,4,3,9,21,28,1
117,Giorgio Chiellini,ITA,DF,Juventus,36,1984,15.0,22,13,17,4,1,7,13,53.8,6,24,18,6,22,44,59,0
118,Federico Chiesa,ITA,MF|FW,Juventus,23,1997,9.6,26,19,9,9,8,12,26,46.2,14,7,0,7,4,30,3,0
119,Vlad Chiricheș,ROU,DF,Sassuolo,31,1989,25.6,28,15,19,9,0,10,21,47.6,11,34,21,13,41,69,71,4
120,Riccardo Ciervo,ITA,MF|DF,Sampdoria,19,2002,2.5,8,3,4,3,1,2,6,33.3,4,1,0,1,2,10,2,0
121,Moustapha Cissé,GUI,FW,Atalanta,17,2003,0.4,1,0,0,1,0,0,3,0.0,3,0,0,0,0,1,0,0
122,Giorgio Cittadini,ITA,DF,Atalanta,19,2002,0.0,0,0,0,0,0,0,0,,0,0,0,0,1,1,0,0
123,Ebrima Colley,GAM,FW|MF,Spezia,21,2000,4.4,6,1,3,2,1,1,7,14.3,6,8,0,8,3,9,2,0
124,Omar Colley,GAM,DF,Sampdoria,28,1992,30.5,47,36,32,14,1,22,32,68.8,10,31,19,12,80,127,135,2
125,Andrea Consigli,ITA,GK,Sassuolo,34,1987,36.9,0,0,0,0,0,0,2,0.0,2,0,0,0,0,0,23,3
126,Andrea Conti,ITA,DF|MF,Sampdoria,27,1994,2.6,4,2,2,1,1,3,6,50.0,3,4,0,4,7,11,4,0
127,Andrea Conti,ITA,DF,Milan,27,1994,0.1,0,0,0,0,0,0,0,,0,0,0,0,0,0,0,0
128,Diego Coppola,ITA,DF,Hellas Verona,17,2003,2.8,8,4,4,4,0,3,3,100.0,0,5,1,4,4,12,5,0
129,Joaquín Correa,ARG,FW,Inter,26,1994,11.4,11,5,2,6,3,1,13,7.7,12,8,1,7,3,14,2,0
130,Lassana Coulibaly,MLI,MF,Salernitana,25,1996,25.9,58,32,29,26,3,24,62,38.7,38,40,13,27,22,80,27,0
131,Mamadou Coulibaly,SEN,MF,Salernitana,22,1999,9.0,15,12,8,5,2,7,20,35.0,13,9,0,9,11,26,9,0
132,Alessio Cragno,ITA,GK,Cagliari,27,1994,35.0,3,3,2,1,0,3,3,100.0,0,0,0,0,1,4,14,1
133,Domenico Criscito,ITA,DF,Genoa,34,1986,18.0,37,21,19,14,4,16,25,64.0,9,22,12,10,39,76,57,0
134,Bryan Cristante,ITA,MF,Roma,26,1995,29.8,79,39,31,39,9,37,69,53.6,32,31,5,26,40,119,45,0
135,Domen Črnigoj,SVN,MF,Venezia,25,1995,20.9,21,13,7,11,3,11,29,37.9,18,27,8,19,24,45,42,0
136,Giovanni Crociata,ITA,FW,Empoli,23,1997,0.2,0,0,0,0,0,0,1,0.0,1,0,0,0,0,0,0,0
137,Juan Cuadrado,COL,DF|MF,Juventus,33,1988,27.6,48,23,30,13,5,30,55,54.5,25,23,5,18,29,77,34,0
138,Mickaël Cuisance,FRA,MF,Venezia,21,1999,10.2,23,9,7,12,4,10,28,35.7,18,14,0,14,12,35,5,0
139,Patrick Cutrone,ITA,FW,Empoli,23,1998,15.6,5,2,0,3,2,1,9,11.1,8,11,1,10,5,10,1,0
140,Danilo D'Ambrosio,ITA,DF,Inter,32,1988,11.1,30,15,21,8,1,11,22,50.0,11,21,10,11,8,38,20,0
141,Mikkel Damsgaard,DEN,MF|FW,Sampdoria,21,2000,6.4,27,13,12,11,4,20,36,55.6,16,16,1,15,7,34,7,0
142,Danilo,BRA,DF|MF,Juventus,30,1991,21.0,37,26,20,13,4,18,28,64.3,10,21,12,9,32,69,53,1
143,Ebrima Darboe,GAM,MF,Roma,20,2001,0.7,1,1,0,1,0,0,0,,0,0,0,0,1,2,0,1
144,Matteo Darmian,ITA,DF,Inter,31,1989,16.7,32,16,17,9,6,16,41,39.0,25,16,1,15,19,51,25,0
145,Paweł Dawidowicz,POL,DF,Hellas Verona,26,1995,13.3,30,18,16,10,4,16,25,64.0,9,14,11,3,21,51,53,0
146,Sebastien De Maio,FRA,DF,Udinese,34,1987,2.0,5,1,4,1,0,1,9,11.1,8,6,5,1,1,6,9,0
147,Tommaso De Nipoti,ITA,FW,Atalanta,18,2003,0.1,0,0,0,0,0,0,0,,0,0,0,0,0,0,0,0
148,Mattia De Sciglio,ITA,DF,Juventus,28,1992,13.0,24,12,7,9,8,11,24,45.8,13,10,0,10,10,34,30,0
149,Lorenzo De Silvestri,ITA,DF,Bologna,33,1988,25.5,23,14,13,8,2,9,31,29.0,22,25,7,18,26,49,52,0
150,Grégoire Defrel,MTQ,FW,Sassuolo,30,1991,15.1,15,9,4,8,3,6,16,37.5,10,11,1,10,4,19,11,0
151,Alessandro Deiola,ITA,MF,Cagliari,25,1995,23.7,47,22,15,25,7,23,58,39.7,35,28,10,18,26,73,45,0
152,Filippo Delli Carri,ITA,DF,Salernitana,22,1999,3.7,6,4,4,2,0,5,14,35.7,9,6,2,4,4,10,14,0
153,Merih Demiral,TUR,DF,Atalanta,23,1998,21.3,31,17,18,12,1,15,28,53.6,13,26,14,12,58,89,68,1
154,Diego Demme,GER,MF,Napoli,29,1991,7.7,21,12,4,13,4,10,21,47.6,11,11,2,9,9,30,2,0
155,Fabio Depaoli,ITA,DF,Hellas Verona,24,1997,7.8,12,7,6,4,2,1,7,14.3,6,9,2,7,8,20,14,0
156,Fabio Depaoli,ITA,MF|DF,Sampdoria,24,1997,1.2,3,1,1,2,0,0,2,0.0,2,2,1,1,1,4,2,0
157,Mattia Destro,ITA,FW,Genoa,30,1991,19.4,9,4,1,4,4,1,6,16.7,5,14,1,13,2,11,16,0
158,Gerard Deulofeu,ESP,FW|MF,Udinese,27,1994,29.1,11,6,2,3,6,7,29,24.1,22,14,0,14,9,20,4,0
159,Jacopo Dezi,ITA,MF,Venezia,29,1992,0.2,0,0,0,0,0,0,1,0.0,1,0,0,0,1,1,0,0
160,Samuel Di Carmine,ITA,FW,Hellas Verona,32,1988,0.4,0,0,0,0,0,0,0,,0,0,0,0,0,0,0,0
161,Federico Di Francesco,ITA,FW|MF,Empoli,27,1994,15.2,16,5,2,8,6,9,23,39.1,14,17,1,16,9,25,11,0
162,Giovanni Di Lorenzo,ITA,DF,Napoli,27,1993,31.9,58,36,30,20,8,33,58,56.9,25,28,10,18,38,96,46,1
163,Francesco Di Mariano,ITA,FW,Venezia,25,1996,0.7,1,1,0,1,0,0,0,,0,2,1,1,0,1,0,0
164,Francesco Di Tacchio,ITA,MF,Salernitana,31,1990,13.9,17,7,5,10,2,9,25,36.0,16,16,8,8,22,39,25,0
165,Amadou Diawara,GUI,MF,Roma,24,1997,1.9,7,2,5,2,0,1,3,33.3,2,2,0,2,0,7,1,0
166,Brahim Díaz,ESP,MF,Milan,21,1999,20.6,23,17,3,11,9,8,22,36.4,14,11,0,11,8,31,4,0
167,Mitchell Dijks,NED,DF|FW,Bologna,28,1993,7.7,15,6,6,6,3,5,12,41.7,7,11,2,9,3,18,10,1
168,Federico Dimarco,ITA,DF,Inter,23,1997,15.9,28,15,10,15,3,13,24,54.2,11,6,1,5,19,47,19,0
169,Filippo Distefano,ITA,FW,Fiorentina,17,2003,0.0,0,0,0,0,0,0,0,,0,0,0,0,0,0,0,0
170,Koffi Djidji,CIV,DF,Torino,28,1992,19.3,48,29,21,23,4,14,18,77.8,4,20,9,11,34,82,60,0
171,Berat Djimsiti,ALB,DF,Atalanta,28,1993,25.1,43,24,21,20,2,29,46,63.0,17,21,11,10,31,74,56,0
172,Nicolás Domínguez,ARG,MF,Bologna,23,1998,22.4,76,45,36,32,8,32,76,42.1,44,38,9,29,32,108,34,1
173,Bartłomiej Drągowski,POL,GK,Fiorentina,23,1997,6.2,0,0,0,0,0,0,0,,0,0,0,0,1,1,5,2
174,Radu Drăgușin,ROU,DF,Sampdoria,19,2002,6.9,4,3,2,2,0,2,6,33.3,4,8,4,4,10,14,33,0
175,Radu Drăgușin,ROU,DF,Salernitana,19,2002,5.4,5,4,2,3,0,4,10,40.0,6,7,3,4,13,18,17,0
176,Denzel Dumfries,NED,DF,Inter,25,1996,22.5,32,12,9,14,9,16,32,50.0,16,15,6,9,9,41,26,0
177,Alfred Duncan,GHA,MF,Fiorentina,28,1993,21.5,34,19,13,16,5,11,32,34.4,21,32,3,29,10,44,7,0
178,Paulo Dybala,ARG,FW|MF,Juventus,27,1993,22.9,30,13,7,14,9,8,35,22.9,27,19,0,19,9,39,4,3
179,Edin Džeko,BIH,FW,Inter,35,1986,27.4,14,8,7,4,3,8,25,32.0,17,22,5,17,4,18,35,0
180,Tyronne Ebuehi,NGA,DF,Venezia,25,1995,12.6,28,12,16,8,4,10,18,55.6,8,13,3,10,16,44,38,1
181,Éderson,BRA,MF,Salernitana,22,1999,12.7,29,18,11,14,4,14,26,53.8,12,11,2,9,19,48,8,0
182,Albin Ekdal,SWE,MF,Sampdoria,32,1989,18.2,43,28,17,21,5,26,56,46.4,30,27,7,20,29,72,25,0
183,Caleb Ekuban,GHA,FW|MF,Genoa,27,1994,19.1,19,12,2,12,5,7,23,30.4,16,19,5,14,9,28,6,0
184,Elif Elmas,MKD,FW|MF,Napoli,21,1999,18.0,25,15,10,10,5,12,28,42.9,16,13,2,11,8,33,17,0
185,Martin Erlic,CRO,DF,Spezia,23,1998,28.6,28,16,18,10,0,10,18,55.6,8,54,39,15,28,56,122,1
186,Gonzalo Escalante,ARG,MF,Lazio,28,1993,0.1,1,0,1,0,0,1,1,100.0,0,2,1,1,1,2,0,0
187,Diego Falcinelli,ITA,FW,Bologna,30,1991,0.7,2,2,2,0,0,0,0,,0,0,0,0,1,3,1,0
188,Wladimiro Falcone,ITA,GK,Sampdoria,26,1995,9.5,0,0,0,0,0,0,0,,0,0,0,0,1,1,5,0
189,Paolo Faragò,ITA,MF,Cagliari,28,1993,0.2,1,1,1,0,0,0,0,,0,2,0,2,0,1,0,0
190,Davide Faraoni,ITA,DF,Hellas Verona,29,1991,28.6,62,40,38,21,3,29,62,46.8,33,38,5,33,23,85,62,1
191,Mohamed Fares,ALG,DF|FW,Genoa,25,1996,6.5,4,2,1,3,0,0,4,0.0,4,8,3,5,8,12,11,0
192,Diego Farias,BRA,MF|FW,Cagliari,31,1990,0.7,1,1,0,1,0,1,3,33.3,2,0,0,0,0,1,0,0
193,Andrea Favilli,ITA,FW,Genoa,24,1997,0.4,1,1,0,0,1,0,0,,0,0,0,0,0,1,2,0
194,Federico Fazio,ARG,DF,Salernitana,34,1987,15.9,17,11,10,6,1,9,12,75.0,3,21,16,5,27,44,67,1
195,Luiz Felipe,ITA,DF,Lazio,24,1997,27.7,41,23,21,16,4,20,34,58.8,14,40,33,7,33,74,102,1
196,Alex Ferrari,ITA,DF,Sampdoria,27,1994,18.3,40,22,28,9,3,19,33,57.6,14,31,22,9,39,79,63,1
197,Salvador Ferrer,ESP,DF|MF,Spezia,23,1998,16.6,32,18,15,9,8,12,25,48.0,13,24,12,12,18,50,46,0
198,Riccardo Fiamozzi,ITA,DF,Empoli,28,1993,6.9,7,5,2,2,3,2,4,50.0,2,6,5,1,7,14,12,0
199,Luca Fiordilino,ITA,MF,Venezia,25,1996,7.3,21,13,11,6,4,13,27,48.1,14,14,4,10,11,32,12,0
200,Vincenzo Fiorillo,ITA,GK,Salernitana,31,1990,1.0,0,0,0,0,0,0,0,,0,0,0,0,0,0,1,0
201,Alessandro Florenzi,ITA,DF|FW,Milan,30,1991,12.8,28,14,14,7,7,14,32,43.8,18,9,2,7,27,55,10,1
202,Fernando Forestieri,ITA,FW|MF,Udinese,31,1990,0.6,0,0,0,0,0,0,1,0.0,1,1,0,1,0,0,1,0
203,Francesco Forte,ITA,FW,Venezia,28,1993,4.7,3,2,0,2,1,2,5,40.0,3,1,0,1,0,3,2,0
204,Gianluca Frabotta,ITA,DF|MF,Hellas Verona,22,1999,0.2,0,0,0,0,0,0,1,0.0,1,1,0,1,1,1,0,0
205,Davide Frattesi,ITA,MF,Sassuolo,21,1999,31.7,46,16,26,18,2,26,52,50.0,26,44,12,32,29,75,62,1
206,Morten Frendrup,DEN,DF|MF,Genoa,20,2001,7.7,40,24,19,13,8,13,29,44.8,16,19,2,17,17,57,7,1
207,Remo Freuler,SUI,MF,Atalanta,29,1992,26.3,69,39,22,33,14,30,70,42.9,40,48,8,40,35,104,26,1
208,Matteo Gabbia,ITA,DF,Milan,21,1999,6.0,4,3,1,3,0,0,4,0.0,4,2,2,0,8,12,12,0
209,Manolo Gabbiadini,ITA,FW|MF,Sampdoria,29,1991,12.7,6,4,3,2,1,1,7,14.3,6,5,2,3,3,9,10,0
210,Gianluca Gaetano,ITA,MF,Napoli,21,2000,0.2,1,1,1,0,0,1,2,50.0,1,0,0,0,2,3,0,0
211,Luca Gagliano,ITA,FW|DF,Cagliari,21,2000,0.1,0,0,0,0,0,0,0,,0,1,0,1,0,0,1,0
212,Roberto Gagliardini,ITA,MF,Inter,27,1994,7.2,12,6,7,4,1,1,13,7.7,12,14,5,9,9,21,7,0
213,Riccardo Gagliolo,SWE,DF,Salernitana,31,1990,12.6,23,12,16,4,3,16,27,59.3,11,15,8,7,28,51,52,0
214,Nicolas Galazzi,ITA,MF,Venezia,20,2000,0.2,2,1,1,0,1,0,1,0.0,1,0,0,0,0,2,0,0
215,Pablo Galdames Millán,CHI,MF,Genoa,24,1996,11.4,28,12,6,16,6,12,35,34.3,23,16,2,14,8,36,9,1
216,Luca Gemello,ITA,GK,Torino,21,2000,1.0,0,0,0,0,0,0,0,,0,0,0,0,0,0,0,0
217,Paolo Ghiglione,ITA,DF,Genoa,24,1997,6.7,17,12,8,6,3,9,14,64.3,5,11,5,6,10,27,12,1
218,Faouzi Ghoulam,ALG,DF,Napoli,30,1991,3.7,3,1,1,2,0,0,3,0.0,3,2,1,1,3,6,10,0
219,Sebastian Giovinco,ITA,MF,Sampdoria,34,1987,0.4,0,0,0,0,0,0,1,0.0,1,0,0,0,0,0,0,0
220,Olivier Giroud,FRA,FW,Milan,34,1986,21.0,15,11,4,6,5,3,17,17.6,14,13,4,9,3,18,19,0
221,Diego Godín,URU,DF,Cagliari,35,1986,9.1,18,7,13,3,2,10,15,66.7,5,7,5,2,13,31,46,0
222,Edoardo Goldaniga,ITA,DF,Cagliari,27,1993,10.4,12,5,7,5,0,4,11,36.4,7,8,5,3,22,34,23,0
223,Edoardo Goldaniga,ITA,DF|MF,Sassuolo,27,1993,0.0,0,0,0,0,0,0,0,,0,0,0,0,0,0,0,0
224,Cedric Gondo,CIV,FW,Salernitana,24,1996,7.8,5,2,2,2,1,2,5,40.0,3,2,0,2,3,8,2,0
225,Nicolás González,ARG,FW,Fiorentina,23,1998,26.2,21,16,6,8,7,9,28,32.1,19,26,2,24,21,42,4,1
226,Robin Gosens,GER,DF,Atalanta,27,1994,5.1,7,3,3,4,0,4,8,50.0,4,4,0,4,9,16,1,0
227,Robin Gosens,GER,DF,Inter,27,1994,1.9,3,1,1,2,0,0,0,,0,5,2,3,3,6,3,0
228,Alberto Grassi,ITA,MF,Cagliari,26,1995,24.2,47,26,13,30,4,16,38,42.1,22,27,9,18,63,110,33,1
229,Koray Günter,GER,DF,Hellas Verona,26,1994,26.8,32,18,19,11,2,16,32,50.0,16,27,21,6,69,101,110,1
230,Albert Guðmundsson,ISL,FW|MF,Genoa,24,1997,6.7,5,3,2,1,2,3,8,37.5,5,2,0,2,5,10,4,0
231,Emmanuel Gyasi,GHA,FW|MF,Spezia,27,1994,33.7,47,30,31,9,7,21,41,51.2,20,22,4,18,16,63,43,1
232,Norbert Gyömbér,SVK,DF,Salernitana,29,1992,28.5,53,32,40,11,2,33,50,66.0,17,38,24,14,44,97,126,1
233,Nicolas Haas,SUI,MF,Empoli,25,1996,11.1,35,22,15,10,10,17,39,43.6,22,24,4,20,9,44,17,1
234,Samir Handanović,SVN,GK,Inter,37,1984,37.0,1,0,1,0,0,1,2,50.0,1,1,0,1,0,1,6,3
235,Ridgeciano Haps,SUR,DF,Venezia,28,1993,22.8,36,20,26,4,6,11,21,52.4,10,34,12,22,29,65,57,1
236,Abdou Harroui,NED,MF,Sassuolo,23,1998,5.0,11,4,4,7,0,8,11,72.7,3,14,0,14,4,15,5,0
237,Hans Hateboer,NED,DF|MF,Atalanta,27,1994,15.4,22,14,10,8,4,11,26,42.3,15,11,1,10,7,29,20,0
238,Silvan Hefti,SUI,DF,Genoa,23,1997,14.3,50,30,23,22,5,32,58,55.2,26,20,4,16,20,70,34,1
239,Liam Henderson,SCO,MF,Empoli,25,1996,22.4,22,13,7,8,7,9,31,29.0,22,14,4,10,9,31,13,0
240,Dalbert Henrique,BRA,DF|MF,Cagliari,27,1993,23.1,43,23,23,16,4,11,35,31.4,24,28,5,23,24,67,34,0
241,Matheus Henrique,BRA,MF,Sassuolo,23,1997,12.0,10,3,6,3,1,6,24,25.0,18,14,2,12,7,17,12,1
242,Thomas Henry,FRA,FW,Venezia,26,1994,23.5,9,4,2,3,4,5,13,38.5,8,11,5,6,2,11,25,0
243,Theo Hernández,FRA,DF,Milan,23,1997,30.1,53,35,34,14,5,29,40,72.5,11,16,3,13,23,76,29,3
244,Hernani,BRA,MF|FW,Genoa,27,1994,7.6,20,10,8,9,3,13,32,40.6,19,17,4,13,13,33,5,1
245,Daan Heymans,BEL,MF|FW,Venezia,22,1999,2.8,3,1,1,2,0,1,5,20.0,4,7,3,4,4,7,3,0
246,Aaron Hickey,SCO,DF,Bologna,19,2002,31.3,46,29,24,15,7,20,30,66.7,10,36,13,23,29,75,44,0
247,Martin Hongla,CMR,MF,Hellas Verona,23,1998,7.2,14,8,5,6,3,4,8,50.0,4,6,2,4,4,18,16,1
248,Sydney van Hooijdonk,NED,FW|MF,Bologna,21,2000,0.4,0,0,0,0,0,0,1,0.0,1,1,0,1,0,0,0,0
249,Petko Hristov,BUL,DF,Spezia,22,1999,13.9,17,10,11,6,0,10,16,62.5,6,29,23,6,19,36,47,0
250,Elseid Hysaj,ALB,DF,Lazio,27,1994,22.5,46,30,25,17,4,29,45,64.4,16,18,6,12,24,70,34,1
251,Roger Ibanez,BRA,DF,Roma,22,1998,32.1,54,32,31,19,4,26,43,60.5,17,26,7,19,62,116,104,2
252,Zlatan Ibrahimović,SWE,FW,Milan,39,1981,11.3,0,0,0,0,0,0,2,0.0,2,2,1,1,3,3,9,0
253,Igor,BRA,DF,Fiorentina,23,1998,24.9,53,31,34,16,3,30,40,75.0,10,37,19,18,31,84,46,4
254,Jonathan Ikone,FRA,FW,Fiorentina,23,1998,7.2,7,3,2,3,2,3,10,30.0,7,10,2,8,1,8,2,0
255,Ivan Ilić,SRB,MF,Hellas Verona,20,2001,28.1,39,18,16,19,4,20,54,37.0,34,34,12,22,22,61,55,0
256,Josip Iličić,SVN,MF|FW,Atalanta,33,1988,9.3,7,7,3,2,2,4,17,23.5,13,6,1,5,3,10,1,0
257,Ciro Immobile,ITA,FW,Lazio,31,1990,30.1,10,5,4,4,2,1,15,6.7,14,7,1,6,3,13,16,0
258,Lorenzo Insigne,ITA,FW,Napoli,30,1991,25.4,23,14,8,12,3,8,44,18.2,36,30,1,29,20,43,3,1
259,Ardian Ismajli,ALB,DF,Empoli,24,1996,14.1,13,9,8,4,1,5,14,35.7,9,21,11,10,24,37,80,0
260,Armando Izzo,ITA,DF,Torino,29,1992,5.8,16,9,14,2,0,9,11,81.8,2,5,4,1,17,33,21,0
261,Mato Jajalo,BIH,MF,Udinese,33,1988,7.0,24,14,14,7,3,11,23,47.8,12,7,0,7,11,35,5,0
262,Paweł Jaroszyński,POL,DF,Salernitana,26,1994,5.7,10,5,7,3,0,5,7,71.4,2,4,0,4,10,20,19,0
263,Juan Jesus,BRA,DF,Napoli,30,1991,14.2,25,17,14,11,0,12,18,66.7,6,21,16,5,9,34,34,0
264,Dennis Johnsen,NOR,FW|MF,Venezia,23,1998,16.1,14,10,8,4,2,6,18,33.3,12,14,1,13,5,19,3,0
265,Kaio Jorge,BRA,MF|FW,Juventus,19,2002,1.3,2,1,0,2,0,1,3,33.3,2,1,0,1,0,2,2,0
266,Flavio Junior Bianchi,ITA,FW|MF,Genoa,21,2000,3.5,2,2,1,0,1,0,2,0.0,2,0,0,0,0,2,0,0
267,Hamed Junior Traorè,CIV,FW|MF,Sassuolo,21,2000,19.7,32,18,8,14,10,10,46,21.7,36,22,2,20,12,44,6,1
268,Nikola Kalinić,CRO,FW,Hellas Verona,33,1988,4.5,2,0,0,1,1,1,2,50.0,1,2,0,2,0,2,2,0
269,Yayah Kallon,SLE,FW|MF,Genoa,20,2001,7.1,15,11,5,6,4,3,11,27.3,8,7,1,6,1,16,5,0
270,Pierre Kalulu,FRA,DF,Milan,21,2000,21.6,61,36,36,21,4,17,22,77.3,5,36,15,21,26,87,54,0
271,Dimitrije Kamenović,SRB,DF,Lazio,21,2000,0.5,1,1,1,0,0,1,1,100.0,0,0,0,0,2,3,1,0
272,Rick Karsdorp,NED,DF|FW,Roma,26,1995,32.0,53,38,33,13,7,28,50,56.0,22,22,5,17,34,87,26,1
273,Denso Kasius,NED,DF|FW,Bologna,18,2002,2.0,9,7,5,3,1,2,5,40.0,3,4,0,4,3,12,4,0
274,Grigoris Kastanos,CYP,MF|FW,Salernitana,23,1998,15.0,30,19,9,19,2,7,23,30.4,16,21,5,16,22,52,8,0
275,Moise Kean,ITA,FW,Juventus,21,2000,12.2,9,4,2,5,2,6,16,37.5,10,5,0,5,3,12,8,1
276,Wajdi Kechrida,TUN,DF|MF,Salernitana,25,1995,10.6,9,6,6,3,0,8,13,61.5,5,10,2,8,8,17,15,0
277,Dimitrios Keramitsis,GRE,MF,Roma,17,2004,0.0,0,0,0,0,0,0,0,,0,0,0,0,0,0,0,0
278,Franck Kessié,CIV,MF,Milan,24,1996,25.6,41,23,12,24,5,17,26,65.4,9,39,10,29,23,64,22,0
279,Jakub Kiwior,POL,MF,Spezia,21,2000,21.8,50,27,25,19,6,26,57,45.6,31,38,15,23,40,90,53,0
280,Sofian Kiyine,MAR,MF|FW,Venezia,23,1997,13.8,24,14,9,11,4,12,32,37.5,20,15,1,14,10,34,9,0
281,Simon Kjær,DEN,DF,Milan,32,1989,8.9,20,12,9,8,3,6,12,50.0,6,17,13,4,9,29,39,0
282,Aleksandr Kokorin,RUS,FW|MF,Fiorentina,30,1991,0.6,1,1,1,0,0,0,0,,0,1,0,1,0,1,0,0
283,Aleksandar Kolarov,SRB,DF,Inter,35,1985,0.5,1,1,1,0,0,1,1,100.0,0,0,0,0,1,2,2,0
284,Teun Koopmeiners,NED,MF,Atalanta,23,1998,23.6,40,24,10,19,11,22,54,40.7,32,31,2,29,15,55,19,0
285,Kalidou Koulibaly,SEN,DF,Napoli,30,1991,26.7,39,23,31,6,2,25,38,65.8,13,41,25,16,29,68,90,1
286,Christos Kourfalidis,GRE,MF|FW,Cagliari,18,2002,0.2,0,0,0,0,0,0,1,0.0,1,1,0,1,0,0,0,0
287,Viktor Kovalenko,UKR,MF,Spezia,25,1996,14.7,16,10,7,8,1,9,21,42.9,12,16,3,13,13,29,8,0
288,Julian Kristoffersen,NOR,FW,Salernitana,24,1997,0.1,0,0,0,0,0,0,0,,0,0,0,0,0,0,0,0
289,Rade Krunić,BIH,MF|FW,Milan,27,1993,15.7,33,18,16,14,3,15,31,48.4,16,19,2,17,16,49,17,0
290,Dejan Kulusevski,SWE,FW|MF,Juventus,21,2000,8.6,15,12,9,6,0,8,21,38.1,13,14,0,14,5,20,5,0
291,Marash Kumbulla,ALB,DF,Roma,21,2000,11.4,21,13,13,7,1,8,15,53.3,7,17,8,9,16,37,26,0
292,Giorgos Kyriakopoulos,GRE,DF|FW,Sassuolo,25,1996,21.9,30,14,19,7,4,19,38,50.0,19,32,9,23,11,41,52,0
293,Andrea La Mantia,ITA,FW|MF,Empoli,30,1991,5.4,2,0,0,0,2,1,2,50.0,1,3,1,2,1,3,6,0
294,Sam Lammers,NED,FW|MF,Atalanta,24,1997,0.4,1,0,0,0,1,0,0,,0,0,0,0,0,1,0,0
295,Kevin Lasagna,ITA,MF|FW,Hellas Verona,28,1992,13.2,13,7,4,5,4,4,15,26.7,11,16,0,16,3,16,7,0
296,Darko Lazović,SRB,DF,Hellas Verona,30,1990,30.7,36,23,20,8,8,21,39,53.8,18,28,4,24,19,55,49,1
297,Manuel Lazzari,ITA,DF,Lazio,27,1993,18.5,28,14,13,15,0,16,26,61.5,10,10,2,8,12,40,16,1
298,Patrick Leal,USA,FW,Venezia,18,2003,0.0,0,0,0,0,0,0,1,0.0,1,0,0,0,0,0,0,0
299,Rafael Leão,POR,FW,Milan,22,1999,28.9,17,7,3,9,5,10,20,50.0,10,12,1,11,12,29,8,0
300,Lucas Leiva,BRA,MF,Lazio,34,1987,18.9,55,30,26,25,4,15,53,28.3,38,27,10,17,28,83,37,0
301,Luca Lezzerini,ITA,GK,Venezia,26,1995,5.5,0,0,0,0,0,0,0,,0,1,0,1,0,0,0,0
302,Ben Lhassine Kone,CIV,MF,Torino,21,2000,0.9,3,3,1,2,0,1,2,50.0,1,0,0,0,1,4,1,0
303,Matthijs de Ligt,NED,DF,Juventus,21,1999,29.7,34,19,21,13,0,15,18,83.3,3,31,21,10,26,60,103,0
304,Anderson Lima,BRA,MF,Lazio,21,1999,0.7,2,0,1,1,0,0,2,0.0,2,1,0,1,2,4,1,0
305,Karol Linetty,POL,MF|FW,Torino,26,1995,10.0,14,8,3,4,7,6,18,33.3,12,8,0,8,3,17,2,0
306,Stanislav Lobotka,SVK,MF,Napoli,26,1994,18.7,39,24,16,20,3,14,36,38.9,22,9,1,8,12,51,13,1
307,Manuel Locatelli,ITA,MF,Juventus,23,1998,24.0,44,25,21,16,7,21,47,44.7,26,43,21,22,22,66,33,0
308,Maxime Lopez,FRA,MF,Sassuolo,23,1997,32.6,69,36,40,27,2,35,87,40.2,52,33,7,26,42,111,38,1
309,Matteo Lovato,ITA,DF,Atalanta,21,2000,3.4,5,4,4,1,0,0,1,0.0,1,4,2,2,7,12,8,0
310,Matteo Lovato,ITA,DF,Cagliari,21,2000,13.8,23,15,13,10,0,8,20,40.0,12,21,10,11,28,51,43,0
311,Hirving Lozano,MEX,FW,Napoli,26,1995,17.9,28,20,12,11,5,8,30,26.7,22,24,0,24,9,37,9,0
312,José Luis Palomino,ARG,DF,Atalanta,31,1990,29.7,78,40,42,33,3,32,50,64.0,18,43,21,22,100,178,80,2
313,Saša Lukić,SRB,MF,Torino,24,1996,33.1,51,34,17,27,7,19,43,44.2,24,34,6,28,24,75,41,0
314,Sebastiano Luperto,ITA,DF,Empoli,24,1996,21.8,29,17,17,10,2,10,20,50.0,10,32,26,6,45,74,132,0
315,Charalambos Lykogiannis,GRE,DF|FW,Cagliari,27,1993,20.2,19,12,16,1,2,11,20,55.0,9,18,8,10,31,50,73,0
316,Niki Mäenpää,FIN,GK,Venezia,36,1985,16.5,0,0,0,0,0,0,0,,0,0,0,0,0,0,8,2
317,Giulio Maggiore,ITA,MF,Spezia,23,1998,31.3,58,32,20,32,6,31,77,40.3,46,30,5,25,29,87,33,0
318,Francesco Magnanelli,ITA,MF,Sassuolo,36,1984,3.0,5,4,4,1,0,1,9,11.1,8,3,1,2,1,6,3,0
319,Giangiacomo Magnani,ITA,DF,Hellas Verona,25,1995,5.9,10,7,5,5,0,8,16,50.0,8,5,3,2,10,20,46,0
320,Giangiacomo Magnani,ITA,DF,Sampdoria,25,1995,2.7,4,2,4,0,0,1,1,100.0,0,2,2,0,7,11,12,0
321,Mike Maignan,FRA,GK,Milan,26,1995,32.0,2,1,2,0,0,2,2,100.0,0,0,0,0,1,3,4,2
322,Ainsley Maitland-Niles,ENG,DF,Roma,23,1997,5.4,8,6,5,0,3,5,14,35.7,9,7,0,7,6,14,7,0
323,Jean-Victor Makengo,FRA,MF,Udinese,23,1998,26.1,30,21,7,17,6,15,29,51.7,14,26,6,20,19,49,17,0
324,Nikola Maksimović,SRB,DF,Genoa,29,1991,12.4,14,6,10,4,0,7,9,77.8,2,17,11,6,12,26,61,1
325,Kévin Malcuit,MAR,DF|MF,Napoli,30,1991,3.2,4,2,4,0,0,2,2,100.0,0,3,0,3,8,12,6,0
326,Daniel Maldini,ITA,MF,Milan,19,2001,1.6,8,3,4,3,1,2,6,33.3,4,4,0,4,1,9,0,0
327,Youssef Maleh,MAR,MF,Fiorentina,22,1998,11.3,27,16,8,13,6,12,25,48.0,13,14,1,13,6,33,2,0
328,Ruslan Malinovskyi,UKR,MF|FW,Atalanta,28,1993,17.7,18,10,3,10,5,5,19,26.3,14,27,3,24,5,23,1,0
329,Rey Manaj,ALB,FW,Spezia,24,1997,19.6,19,12,3,11,5,6,26,23.1,20,16,0,16,4,23,13,0
330,Gianluca Mancini,ITA,DF,Roma,25,1996,32.0,41,25,22,18,1,18,33,54.5,15,38,19,19,39,80,69,0
331,Leonardo Mancuso,ITA,FW,Empoli,29,1992,4.7,1,1,0,1,0,0,6,0.0,6,2,0,2,1,2,2,0
332,Rolando Mandragora,ITA,MF,Torino,24,1997,14.7,21,10,3,16,2,12,21,57.1,9,18,4,14,10,31,13,0
333,Kostas Manolas,GRE,DF,Napoli,30,1991,3.5,2,2,1,1,0,2,3,66.7,1,2,1,1,4,6,10,1
334,Riccardo Marchizza,ITA,DF,Empoli,23,1998,15.0,21,15,11,8,2,11,16,68.8,5,15,6,9,10,31,24,0
335,Gian Marco Ferrari,ITA,DF,Sassuolo,29,1992,34.7,16,11,10,6,0,10,23,43.5,13,37,27,10,43,59,114,2
336,Davide Marfella,ITA,GK,Napoli,21,1999,0.1,0,0,0,0,0,0,0,,0,0,0,0,0,0,0,0
337,Pablo Marí,ESP,DF,Udinese,27,1993,14.9,16,8,8,6,2,8,16,50.0,8,18,12,6,21,37,72,0
338,Răzvan Marin,ROU,MF,Cagliari,25,1996,31.3,42,21,16,22,4,24,54,44.4,30,23,5,18,10,52,17,1
339,Lautaro Martínez,ARG,FW,Inter,23,1997,25.4,20,10,3,10,7,6,11,54.5,5,21,1,20,18,38,6,0
340,Lucas Martínez Quarta,ARG,DF,Fiorentina,25,1996,15.9,36,25,23,11,2,21,34,61.8,13,22,9,13,19,55,46,0
341,Adam Marušić,MNE,DF,Lazio,28,1992,30.2,30,18,16,12,2,13,32,40.6,19,19,8,11,41,71,71,0
342,Andrea Masiello,ITA,DF,Genoa,35,1986,5.7,5,3,4,1,0,4,7,57.1,3,8,4,4,11,16,20,1
343,Aleš Matějů,CZE,DF,Venezia,25,1996,8.1,16,12,10,5,1,13,29,44.8,16,10,6,4,9,25,15,0
344,Borja Mayoral,ESP,FW|DF,Roma,24,1997,1.1,0,0,0,0,0,0,0,,0,0,0,0,0,0,0,0
345,Pasquale Mazzocchi,ITA,DF,Venezia,26,1995,13.8,18,8,11,4,3,10,26,38.5,16,11,8,3,21,39,31,1
346,Pasquale Mazzocchi,ITA,DF,Salernitana,26,1995,14.1,28,19,15,11,2,14,34,41.2,20,5,0,5,11,39,31,0
347,Ibrahima Mbaye,SEN,DF,Bologna,26,1994,1.2,1,1,1,0,0,1,2,50.0,1,1,1,0,1,2,6,0
348,Weston McKennie,USA,MF,Juventus,22,1998,15.2,20,11,11,7,2,8,26,30.8,18,17,8,9,23,43,20,0
349,Gary Medel,CHI,DF,Bologna,33,1987,31.4,39,23,27,11,1,16,36,44.4,20,30,21,9,44,83,112,0
350,Filippo Melegoni,ITA,MF|FW,Genoa,22,1999,10.9,20,12,5,8,7,8,16,50.0,8,10,1,9,11,31,8,1
351,Arthur Melo,BRA,MF,Juventus,24,1996,10.7,25,12,10,14,1,13,24,54.2,11,11,2,9,7,32,8,1
352,Alex Meret,ITA,GK,Napoli,24,1997,6.9,0,0,0,0,0,0,0,,0,0,0,0,0,0,3,1
353,Yıldırım Mert Çetin,TUR,MF,Hellas Verona,24,1997,0.5,1,0,1,0,0,1,1,100.0,0,0,0,0,0,1,2,0
354,Dries Mertens,BEL,FW|MF,Napoli,34,1987,15.4,16,7,1,11,4,3,16,18.8,13,8,2,6,9,25,2,0
355,Junior Messias,BRA,FW|MF,Milan,30,1991,15.9,34,18,11,14,9,15,34,44.1,19,11,1,10,17,51,17,0
356,Kingsley Michael,NGA,MF,Bologna,21,1999,0.8,4,1,2,2,0,1,2,50.0,1,2,1,1,1,5,1,1
357,Valentin Mihaila,ROU,MF|FW,Atalanta,21,2000,0.8,1,1,0,1,0,0,1,0.0,1,2,0,2,0,1,0,0
358,Mikael,BRA,FW|MF,Salernitana,22,1999,1.0,1,1,0,1,0,0,0,,0,0,0,0,0,1,1,0
359,Hilmir Mikaelsson,ISL,FW,Venezia,17,2004,0.2,2,0,0,1,1,0,0,,0,0,0,0,0,2,0,0
360,Nikola Milenković,SRB,DF,Fiorentina,23,1997,32.5,54,32,31,20,3,29,34,85.3,5,30,15,15,39,93,94,0
361,Sergej Milinković-Savić,SRB,MF,Lazio,26,1995,34.4,67,44,20,32,15,29,67,43.3,38,50,9,41,34,101,43,1
362,Vanja Milinković-Savić,SRB,GK,Torino,24,1997,27.0,0,0,0,0,0,0,1,0.0,1,0,0,0,0,0,7,2
363,Aleksei Miranchuk,RUS,MF|FW,Atalanta,25,1995,8.6,11,7,3,7,1,4,12,33.3,8,3,0,3,1,12,7,0
364,Fabio Miretti,ITA,MF,Juventus,17,2003,3.6,4,2,2,2,0,2,9,22.2,7,3,1,2,2,6,3,0
365,Henrikh Mkhitaryan,ARM,MF|FW,Roma,32,1989,27.7,45,29,11,27,7,17,52,32.7,35,33,2,31,22,67,33,0
366,Marco Modolo,ITA,DF,Venezia,32,1989,4.4,6,3,4,2,0,2,5,40.0,3,6,6,0,4,10,26,0
367,Nahuel Molina,ARG,DF,Udinese,23,1998,29.3,41,24,17,21,3,16,48,33.3,32,24,3,21,22,63,44,2
368,Cristian Molinaro,ITA,DF,Venezia,38,1983,6.1,12,9,10,2,0,5,7,71.4,2,7,2,5,6,18,20,0
369,Lorenzo Montipò,ITA,GK,Hellas Verona,25,1996,34.0,0,0,0,0,0,0,0,,0,0,0,0,1,1,16,3
370,Álvaro Morata,ESP,FW,Juventus,28,1992,25.6,18,9,4,9,5,8,31,25.8,23,26,1,25,5,23,24,0
371,Raúl Moro,ESP,FW,Lazio,18,2002,2.2,3,3,0,2,1,1,5,20.0,4,2,0,2,0,3,0,0
372,Andrei Motoc,ROU,DF,Salernitana,19,2002,1.0,1,1,0,1,0,0,0,,0,2,2,0,2,3,1,0
373,Lys Mousset,FRA,MF|FW,Salernitana,25,1996,1.8,1,0,0,1,0,0,0,,0,2,0,2,0,1,0,0
374,Samuel Mráz,SVK,FW,Spezia,24,1997,0.6,0,0,0,0,0,0,0,,0,1,0,1,0,0,0,0
375,Mert Müldür,TUR,DF,Sassuolo,22,1999,22.7,52,35,43,7,2,27,49,55.1,22,25,6,19,24,76,44,1
376,Luis Muriel,COL,FW|MF,Atalanta,30,1991,17.1,15,4,2,7,6,3,19,15.8,16,12,0,12,4,19,5,0
377,Vedat Muriqi,KVX,FW,Lazio,27,1994,2.4,1,0,1,0,0,0,5,0.0,5,0,0,0,0,1,2,0
378,Nicola Murru,ITA,DF,Sampdoria,26,1994,10.9,22,17,10,11,1,8,13,61.5,5,17,3,14,7,29,20,1
379,Juan Musso,ARG,GK,Atalanta,27,1994,32.6,1,1,1,0,0,0,0,,0,0,0,0,0,1,17,1
380,Joakim Mæhle,DEN,DF|MF,Atalanta,24,1997,16.3,21,11,6,9,6,12,27,44.4,15,18,2,16,14,35,13,0
381,Nahitan Nández,URU,MF|DF,Cagliari,25,1995,16.9,39,21,16,15,8,18,33,54.5,15,16,1,15,9,48,15,1
382,Nani,POR,MF|FW,Venezia,34,1986,3.2,2,1,1,1,0,0,1,0.0,1,1,0,1,2,4,0,1
383,Matija Nastasić,SRB,DF,Fiorentina,28,1993,2.4,1,1,1,0,0,1,1,100.0,0,1,1,0,5,6,11,0
384,Ilija Nestorovski,MKD,FW,Udinese,31,1990,2.1,0,0,0,0,0,0,3,0.0,3,0,0,0,0,0,4,0
385,Aurélien Nguiamba,FRA,MF,Spezia,22,1999,0.6,3,2,1,2,0,2,3,66.7,1,2,1,1,0,3,1,0
386,Dimitris Nikolaou,GRE,DF,Spezia,22,1998,36.0,39,26,29,7,3,22,34,64.7,12,48,24,24,49,88,132,1
387,Jean-Pierre Nsame,CMR,FW,Venezia,28,1993,2.7,1,1,0,0,1,0,0,,0,0,0,0,0,1,1,0
388,Bram Nuytinck,NED,DF,Udinese,31,1990,22.6,38,24,24,13,1,15,34,44.1,19,42,31,11,22,60,101,0
389,Simeon Nwankwo,NGA,FW,Salernitana,29,1992,9.4,5,5,0,4,1,4,10,40.0,6,8,3,5,3,8,10,0
390,M'Bala Nzola,ANG,FW,Spezia,24,1996,11.9,2,2,0,0,2,1,6,16.7,5,8,0,8,0,2,13,0
391,Adam Obert,SVK,DF|MF,Cagliari,18,2002,3.0,8,5,6,2,0,5,6,83.3,1,6,4,2,4,12,11,0
392,Joel Obi,NGA,MF|DF,Salernitana,30,1991,12.7,23,14,5,14,4,5,12,41.7,7,17,6,11,10,33,7,0
393,Brian Oddei,ITA,FW,Sassuolo,18,2002,0.1,0,0,0,0,0,0,0,,0,0,0,0,0,0,0,0
394,Álvaro Odriozola,ESP,DF,Fiorentina,25,1995,19.3,25,15,12,6,7,15,32,46.9,17,17,6,11,8,33,25,2
395,Stefano Okaka,ITA,FW,Udinese,31,1989,0.2,0,0,0,0,0,0,0,,0,2,0,2,0,0,1,0
396,David Okereke,NGA,FW|MF,Venezia,23,1997,22.8,16,10,4,9,3,3,20,15.0,17,19,3,16,10,26,20,0
397,Christian Oliva,URU,MF,Cagliari,25,1996,0.5,2,2,2,0,0,1,4,25.0,3,0,0,0,0,2,0,0
398,Sérgio Oliveira,POR,MF,Roma,29,1992,9.9,27,14,11,14,2,15,30,50.0,15,13,0,13,10,37,7,0
399,Riccardo Orsolini,ITA,FW|MF,Bologna,24,1997,19.8,21,13,9,11,1,13,29,44.8,16,9,4,5,5,26,14,0
400,Victor Osimhen,NGA,FW,Napoli,22,1998,22.0,10,5,1,2,7,2,6,33.3,4,16,3,13,3,13,17,0
401,David Ospina,COL,GK,Napoli,32,1988,31.0,0,0,0,0,0,0,0,,0,0,0,0,1,1,11,1
402,Adam Ounas,ALG,MF|FW,Napoli,24,1996,3.6,6,1,0,3,3,3,7,42.9,4,3,0,3,2,8,3,0
403,Daniele Padelli,ITA,GK,Udinese,35,1985,3.0,0,0,0,0,0,0,0,,0,0,0,0,0,0,2,1
404,Simone Pafundi,ITA,FW,Udinese,15,2006,0.3,0,0,0,0,0,0,1,0.0,1,0,0,0,0,0,0,0
405,Martin Palumbo,NOR,FW,Juventus,19,2002,0.1,0,0,0,0,0,0,1,0.0,1,0,0,0,0,0,0,0
406,Goran Pandev,MKD,FW|MF,Genoa,38,1983,9.4,2,0,1,0,1,0,9,0.0,9,3,1,2,2,4,0,0
407,Ivor Pandur,CRO,GK,Hellas Verona,21,2000,3.0,0,0,0,0,0,0,0,,0,0,0,0,0,0,2,0
408,Fabiano Parisi,ITA,DF,Empoli,20,2000,16.4,35,19,25,5,5,13,31,41.9,18,30,10,20,22,57,42,0
409,Mario Pašalić,CRO,MF|FW,Atalanta,26,1995,22.2,27,12,8,13,6,12,30,40.0,18,27,6,21,20,47,14,0
410,Patric,ESP,DF,Lazio,28,1993,18.3,21,15,17,4,0,9,20,45.0,11,22,11,11,12,33,44,2
411,Rui Patrício,POR,GK,Roma,33,1988,38.0,0,0,0,0,0,0,0,,0,1,0,1,0,0,10,3
412,Leonardo Pavoletti,ITA,FW,Cagliari,32,1988,16.9,10,6,2,5,3,3,9,33.3,6,9,5,4,2,12,12,0
413,Pedro,ESP,FW,Lazio,34,1987,22.6,36,23,8,19,9,16,47,34.0,31,18,2,16,6,42,8,0
414,João Pedro,ITA,FW,Cagliari,29,1992,36.9,15,12,2,8,5,4,18,22.2,14,23,5,18,8,23,18,1
415,Gianluca Pegolo,ITA,GK,Sassuolo,40,1981,1.0,0,0,0,0,0,0,0,,0,0,0,0,0,0,0,1
416,Pietro Pellegri,ITA,FW,Torino,20,2001,2.4,1,1,0,1,0,0,4,0.0,4,0,0,0,0,1,5,0
417,Pietro Pellegri,ITA,FW,Milan,20,2001,1.5,2,2,0,1,1,0,1,0.0,1,0,0,0,0,2,1,0
418,Lorenzo Pellegrini,ITA,MF,Roma,25,1996,25.4,35,14,10,17,8,16,60,26.7,44,29,1,28,27,62,20,0
419,Luca Pellegrini,ITA,DF,Juventus,22,1999,12.3,23,10,13,5,5,12,19,63.2,7,9,1,8,5,28,23,0
420,Federico Peluso,ITA,DF,Sassuolo,37,1984,0.1,1,1,0,1,0,1,1,100.0,0,0,0,0,0,1,0,0
421,Gastón Pereiro,URU,FW|MF,Cagliari,26,1995,10.8,13,5,7,4,2,5,18,27.8,13,12,1,11,1,14,8,0
422,Dor Peretz,ISR,MF,Venezia,26,1995,6.5,27,18,8,16,3,13,25,52.0,12,8,4,4,8,35,11,0
423,Roberto Pereyra,ARG,MF|FW,Udinese,30,1991,19.9,18,12,7,6,5,7,23,30.4,16,26,5,21,12,30,11,0
424,Carles Pérez,ESP,MF|FW,Roma,23,1998,6.2,8,3,3,1,4,3,12,25.0,9,10,0,10,2,10,2,0
425,Nehuén Pérez,ARG,DF,Udinese,21,2000,18.8,44,21,21,21,2,16,25,64.0,9,27,9,18,21,65,47,0
426,Mattia Perin,ITA,GK,Juventus,28,1992,4.5,0,0,0,0,0,0,0,,0,0,0,0,0,0,3,0
427,Ivan Perišić,CRO,DF,Inter,32,1989,31.3,38,22,18,11,9,28,50,56.0,22,39,7,32,47,85,42,0
428,Diego Perotti,ARG,MF|FW,Salernitana,33,1988,3.2,11,5,7,1,3,4,13,30.8,9,1,0,1,2,13,6,0
429,Mario Perrone,ITA,DF,Salernitana,18,2003,0.2,0,0,0,0,0,0,0,,0,0,0,0,0,0,0,0
430,Matteo Pessina,ITA,MF|FW,Atalanta,24,1997,16.0,27,14,10,11,6,14,33,42.4,19,22,3,19,13,40,7,0
431,Andrea Petagna,ITA,FW,Napoli,26,1995,6.5,3,3,0,3,0,1,4,25.0,3,1,0,1,0,3,5,0
432,Giuseppe Pezzella,ITA,DF|MF,Atalanta,23,1997,11.9,28,13,15,7,6,8,18,44.4,10,13,5,8,9,37,16,0
433,Krzysztof Piątek,POL,FW,Fiorentina,26,1995,8.1,5,4,1,1,3,2,3,66.7,1,6,0,6,2,7,8,0
434,Roberto Piccoli,ITA,FW,Genoa,20,2001,2.4,1,1,0,1,0,0,0,,0,0,0,0,1,2,1,1
435,Roberto Piccoli,ITA,FW,Atalanta,20,2001,2.2,2,0,0,0,2,0,2,0.0,2,1,0,1,0,2,0,0
436,Andrea Pinamonti,ITA,FW,Empoli,22,1999,31.9,11,6,0,7,4,2,18,11.1,16,24,3,21,7,18,23,0
437,Carlo Pinsoglio,ITA,GK,Juventus,31,1990,0.5,0,0,0,0,0,0,0,,0,0,0,0,0,0,0,0
438,Riccardo Pinzi,ITA,FW,Udinese,17,2003,0.0,0,0,0,0,0,0,0,,0,0,0,0,0,0,0,0
439,Marko Pjaca,CRO,MF,Torino,26,1995,12.8,7,4,1,4,2,3,8,37.5,5,10,2,8,4,11,2,0
440,Tommaso Pobega,ITA,MF,Torino,22,1999,24.9,48,30,17,20,11,21,40,52.5,19,32,3,29,25,73,38,0
441,Suf Podgoreanu,ISR,FW,Spezia,19,2002,1.3,2,0,1,1,0,1,4,25.0,3,2,0,2,1,3,3,0
442,Matteo Politano,ITA,FW,Napoli,27,1993,18.3,24,12,8,11,5,15,54,27.8,39,11,2,9,13,37,5,0
443,Manolo Portanova,ITA,FW|MF,Genoa,21,2000,14.7,46,28,9,26,11,14,34,41.2,20,26,2,24,17,63,22,0
444,Dennis Praet,BEL,MF,Torino,27,1994,17.1,19,10,6,8,5,8,22,36.4,14,12,1,11,3,22,4,0
445,Mateusz Praszelik,POL,MF,Hellas Verona,20,2000,0.3,0,0,0,0,0,0,0,,0,0,0,0,0,0,0,0
446,Ivan Provedel,ITA,GK,Spezia,27,1994,30.7,0,0,0,0,0,0,1,0.0,1,0,0,0,2,2,10,2
447,Erick Pulgar,CHI,MF,Fiorentina,27,1994,3.8,6,6,4,2,0,4,9,44.4,5,5,1,4,5,11,2,1
448,Ignacio Pussetto,ARG,FW|MF,Udinese,25,1995,13.4,17,9,2,9,6,2,10,20.0,8,18,2,16,4,21,13,0
449,Niklas Pyyhtiä,FIN,MF,Bologna,17,2003,0.2,0,0,0,0,0,0,1,0.0,1,0,0,0,0,0,0,0
450,Fabio Quagliarella,ITA,FW,Sampdoria,38,1983,18.5,6,2,2,2,2,2,15,13.3,13,14,1,13,3,9,12,0
451,Adrien Rabiot,FRA,MF,Juventus,26,1995,25.4,64,43,32,24,8,15,34,44.1,19,34,8,26,20,84,41,1
452,Ivan Radovanović,SRB,DF|MF,Salernitana,32,1988,11.7,11,7,8,3,0,7,19,36.8,12,14,7,7,7,18,29,0
453,Ionuț Radu,ROU,GK,Inter,24,1997,1.0,0,0,0,0,0,0,0,,0,0,0,0,0,0,0,1
454,Ștefan Radu,ROU,DF,Lazio,34,1986,6.2,9,6,3,6,0,5,9,55.6,4,7,2,5,5,14,15,0
455,Boris Radunović,SRB,GK,Cagliari,25,1996,3.0,0,0,0,0,0,0,0,,0,0,0,0,0,0,0,0
456,Antonio Raimondo,ITA,FW,Bologna,17,2004,0.8,0,0,0,0,0,0,1,0.0,1,1,0,1,0,0,1,0
457,Aaron Ramsey,WAL,MF,Juventus,30,1990,1.1,0,0,0,0,0,0,0,,0,0,0,0,1,1,0,0
458,Luca Ranieri,ITA,DF,Salernitana,22,1999,23.4,38,21,23,11,4,19,33,57.6,14,18,8,10,22,60,67,0
459,Andrea Ranocchia,ITA,DF,Inter,33,1988,3.8,8,4,5,1,2,1,3,33.3,2,4,3,1,4,12,16,0
460,Giacomo Raspadori,ITA,MF|FW,Sassuolo,21,2000,30.4,29,18,5,15,9,11,38,28.9,27,29,3,26,9,38,11,0
461,Nicola Ravaglia,ITA,GK,Sampdoria,32,1988,0.1,0,0,0,0,0,0,0,,0,0,0,0,0,0,0,0
462,Ante Rebić,CRO,FW,Milan,27,1993,9.9,14,8,3,6,5,7,20,35.0,13,14,0,14,3,17,3,1
463,Arkadiusz Reca,POL,DF,Spezia,26,1995,19.7,31,19,21,3,7,20,30,66.7,10,20,7,13,32,63,47,2
464,Pepe Reina,ESP,GK,Lazio,38,1982,15.0,0,0,0,0,0,0,1,0.0,1,0,0,0,0,0,1,1
465,Panagiotis Retsos,GRE,DF,Hellas Verona,22,1998,0.6,0,0,0,0,0,0,2,0.0,2,0,0,0,2,2,3,0
466,Bryan Reynolds,USA,DF,Roma,20,2001,0.0,0,0,0,0,0,0,1,0.0,1,0,0,0,0,0,1,0
467,Franck Ribéry,FRA,MF|FW,Salernitana,38,1983,15.8,17,10,6,6,5,8,13,61.5,5,12,0,12,3,20,1,0
468,Samuele Ricci,ITA,MF,Torino,19,2001,8.0,8,4,4,2,2,2,5,40.0,3,7,1,6,14,22,9,0
469,Samuele Ricci,ITA,MF,Empoli,19,2001,17.0,33,19,17,13,3,20,34,58.8,14,24,5,19,31,64,18,0
470,Tomás Rincón,VEN,MF,Torino,33,1988,1.8,2,2,2,0,0,0,3,0.0,3,3,1,2,2,4,4,0
471,Tomás Rincón,VEN,MF,Sampdoria,33,1988,13.0,22,13,9,10,3,13,34,38.2,21,15,2,13,18,40,11,0
472,Ricardo Rodríguez,SUI,DF,Torino,28,1992,27.5,36,21,11,23,2,18,33,54.5,15,22,8,14,41,77,48,1
473,Marko Rog,CRO,MF,Cagliari,26,1995,3.5,5,3,1,2,2,1,8,12.5,7,6,1,5,1,6,3,0
474,Rogério,BRA,DF,Sassuolo,23,1998,19.2,21,13,12,5,4,15,22,68.2,7,20,8,12,18,39,42,1
475,Alessio Romagnoli,ITA,DF,Milan,26,1995,15.7,24,14,14,10,0,14,18,77.8,4,21,12,9,19,43,45,0
476,Simone Romagnoli,ITA,DF,Empoli,31,1990,16.6,28,12,14,12,2,15,20,75.0,5,34,28,6,9,37,86,0
477,Luka Romero,ARG,FW,Lazio,16,2004,0.9,2,1,0,1,1,0,2,0.0,2,0,0,0,1,3,0,0
478,Sergio Romero,ARG,GK,Venezia,34,1987,16.0,2,2,2,0,0,2,2,100.0,0,0,0,0,1,3,10,0
479,Cristiano Ronaldo,POR,FW,Juventus,36,1985,0.3,1,0,0,1,0,1,1,100.0,0,0,0,0,0,1,0,0
480,Marten de Roon,NED,MF|DF,Atalanta,30,1991,28.3,69,42,33,29,7,34,62,54.8,28,36,2,34,45,114,41,0
481,Francesco Rossi,ITA,GK,Atalanta,30,1991,0.4,0,0,0,0,0,0,0,,0,0,0,0,0,0,0,0
482,Nicolò Rovella,ITA,MF,Genoa,19,2001,16.3,37,26,16,14,7,15,40,37.5,25,21,1,20,20,57,20,0
483,Amir Rrahmani,KVX,DF,Napoli,27,1994,32.5,21,11,15,5,1,15,19,78.9,4,36,25,11,19,40,89,0
484,Ruan,BRA,DF,Sassuolo,22,1999,2.4,7,4,7,0,0,3,4,75.0,1,6,5,1,2,9,24,1
485,Daniele Rugani,ITA,DF,Juventus,27,1994,9.8,8,5,4,4,0,4,7,57.1,3,9,4,5,11,19,47,0
486,Matteo Ruggeri,ITA,DF,Salernitana,19,2002,7.5,8,4,5,2,1,7,10,70.0,3,6,1,5,2,10,25,0
487,Mário Rui,POR,DF,Napoli,30,1991,33.2,68,43,32,28,8,39,84,46.4,45,31,7,24,40,108,50,0
488,Fabián Ruiz Peña,ESP,MF,Napoli,25,1996,26.5,55,33,22,29,4,29,67,43.3,38,34,1,33,22,77,32,0
489,Alessandro Russo,ITA,MF,Salernitana,17,2003,0.3,1,0,1,0,0,0,1,0.0,1,0,0,0,0,1,1,0
490,Stefano Sabelli,ITA,DF,Genoa,28,1993,3.9,6,3,3,2,1,3,9,33.3,6,5,1,4,3,9,12,0
491,Abdelhamid Sabiri,MAR,MF|FW,Sampdoria,24,1996,9.9,34,18,10,15,9,7,25,28.0,18,10,2,8,7,41,3,0
492,Alexis Saelemaekers,BEL,FW,Milan,22,1999,20.7,43,22,12,17,14,15,51,29.4,36,19,0,19,15,58,8,0
493,Jacopo Sala,ITA,MF,Spezia,29,1991,9.8,22,11,10,10,2,13,30,43.3,17,6,0,6,14,36,11,0
494,Eddie Salcedo,ITA,MF|FW,Spezia,19,2001,4.8,1,1,0,0,1,0,1,0.0,1,2,1,1,0,1,7,1
495,Lazar Samardzic,SRB,MF|FW,Udinese,19,2002,5.4,13,9,4,7,2,7,26,26.9,19,6,0,6,2,15,2,0
496,Luigi Samele,ITA,FW,Sassuolo,19,2002,0.1,0,0,0,0,0,0,0,,0,0,0,0,0,0,1,0
497,Antonio Sanabria,PAR,FW,Torino,25,1996,20.0,3,2,0,1,2,1,4,25.0,3,11,4,7,2,5,10,0
498,Alexis Sánchez,CHI,FW,Inter,32,1988,9.8,9,8,0,6,3,2,11,18.2,9,4,0,4,2,11,3,0
499,Alex Sandro,BRA,DF,Juventus,30,1991,19.8,27,16,15,9,3,11,25,44.0,14,17,6,11,27,54,40,0
500,Nicola Sansone,ITA,FW|MF,Bologna,29,1991,10.0,13,7,5,6,2,3,15,20.0,12,1,0,1,4,17,2,0
501,Federico Santander,PAR,FW|DF,Bologna,30,1991,0.7,2,1,1,1,0,1,1,100.0,0,0,0,0,0,2,0,0
502,Samir Santos,BRA,DF,Udinese,26,1994,15.8,36,16,22,13,1,15,25,60.0,10,21,7,14,42,78,62,0
503,Riccardo Saponara,ITA,FW,Fiorentina,29,1991,14.3,10,2,1,6,3,6,16,37.5,10,5,0,5,1,11,3,0
504,Giacomo Satalino,ITA,GK,Sassuolo,22,1999,0.1,0,0,0,0,0,0,0,,0,0,0,0,0,0,0,0
505,Martin Satriano,URU,FW|MF,Inter,20,2001,0.4,1,0,0,0,1,1,1,100.0,0,0,0,0,0,1,0,0
506,Giorgio Scalvini,ITA,DF|MF,Atalanta,17,2003,8.5,22,11,13,8,1,9,19,47.4,10,12,1,11,22,44,16,0
507,Gianluca Scamacca,ITA,FW,Sassuolo,22,1999,23.8,19,14,2,5,12,5,21,23.8,16,16,1,15,5,24,22,1
508,Andrea Schiavone,ITA,MF,Salernitana,28,1993,6.3,14,8,5,9,0,10,23,43.5,13,13,3,10,8,22,12,0
509,David Schnegg,AUT,DF,Venezia,22,1998,1.6,2,0,1,1,0,1,3,33.3,2,4,0,4,3,5,6,0
510,Jerdy Schouten,NED,MF,Bologna,24,1997,15.5,25,17,10,12,3,9,22,40.9,13,22,5,17,33,58,29,1
511,Demba Seck,SEN,MF|FW,Torino,20,2001,1.6,2,1,0,2,0,0,0,,0,0,0,0,0,2,0,0
512,Adrian Šemper,CRO,GK,Genoa,23,1998,1.0,0,0,0,0,0,0,0,,0,0,0,0,0,0,0,0
513,Stefano Sensi,ITA,MF|FW,Sampdoria,25,1995,8.4,18,9,10,6,2,10,23,43.5,13,2,0,2,6,24,4,0
514,Stefano Sensi,ITA,MF|FW,Inter,25,1995,1.9,4,3,1,3,0,2,4,50.0,2,2,0,2,0,4,2,0
515,Luigi Sepe,ITA,GK,Salernitana,30,1991,15.5,0,0,0,0,0,0,0,,0,0,0,0,1,1,3,0
516,Laurens Serpe,ITA,DF,Genoa,20,2001,0.5,1,0,1,0,0,1,2,50.0,1,0,0,0,0,1,1,0
517,Stephan El Shaarawy,ITA,FW|DF,Roma,28,1992,11.7,13,8,4,9,0,4,6,66.7,2,10,2,8,11,24,8,0
518,Aimar Sher,SWE,MF,Spezia,18,2002,0.5,2,1,1,1,0,0,1,0.0,1,1,0,1,3,5,1,0
519,Eldor Shomurodov,UZB,FW|MF,Roma,26,1995,8.7,5,4,0,4,1,1,10,10.0,9,8,0,8,2,7,5,0
520,Alassane Sidibe,CIV,MF,Atalanta,19,2002,0.1,1,1,1,0,0,0,0,,0,0,0,0,0,1,0,0
521,Arnór Sigurðsson,ISL,FW|MF,Venezia,22,1999,2.0,1,1,0,1,0,1,2,50.0,1,2,0,2,1,2,0,0
522,Adrien Silva,POR,MF,Sampdoria,32,1989,12.0,24,12,14,5,5,9,33,27.3,24,15,5,10,23,47,23,0
523,Marco Silvestri,ITA,GK,Udinese,30,1991,35.0,0,0,0,0,0,0,1,0.0,1,0,0,0,1,1,11,1
524,Giovanni Simeone,ARG,FW,Hellas Verona,26,1995,29.5,27,15,6,12,9,9,39,23.1,30,37,3,34,6,33,23,0
525,Giovanni Simeone,ARG,FW,Cagliari,26,1995,0.1,0,0,0,0,0,0,0,,0,0,0,0,0,0,0,0
526,Wilfried Singo,CIV,DF,Torino,20,2000,29.0,55,35,24,24,7,24,34,70.6,10,26,6,20,23,78,47,0
527,Salvatore Sirigu,ITA,GK,Genoa,34,1987,37.0,1,1,1,0,0,1,2,50.0,1,0,0,0,0,1,19,2
528,Leo Skiri Østigård,NOR,DF,Genoa,21,1999,13.0,16,9,8,7,1,9,11,81.8,2,17,10,7,8,24,55,1
529,Łukasz Skorupski,POL,GK,Bologna,30,1991,36.0,0,0,0,0,0,0,1,0.0,1,0,0,0,0,0,17,0
530,Andreas Skov Olsen,DEN,FW|DF,Bologna,21,1999,8.3,12,10,4,4,4,5,11,45.5,6,9,1,8,3,15,11,0
531,Milan Škriniar,SVK,DF,Inter,26,1995,35.0,47,27,26,17,4,24,42,57.1,18,36,25,11,25,72,90,1
532,Chris Smalling,ENG,DF,Roma,31,1989,23.2,36,23,28,8,0,18,25,72.0,7,32,24,8,26,62,92,1
533,Brandon Soppy,FRA,DF|MF,Udinese,19,2002,8.6,20,9,8,10,2,11,16,68.8,5,10,2,8,5,25,9,1
534,Roberto Soriano,ITA,MF,Bologna,30,1991,29.1,57,30,27,22,8,17,56,30.4,39,37,3,34,22,79,32,0
535,Riccardo Sottil,ITA,FW,Fiorentina,22,1999,13.8,9,4,4,4,1,3,9,33.3,6,3,0,3,1,10,2,0
536,Matìas Soulé,ARG,FW,Juventus,18,2003,0.1,0,0,0,0,0,0,1,0.0,1,0,0,0,0,0,0,0
537,Adama Soumaoro,FRA,DF,Bologna,29,1992,25.2,15,5,5,8,2,4,9,44.4,5,22,16,6,34,49,95,0
538,Leonardo Spinazzola,ITA,DF,Roma,28,1993,1.4,0,0,0,0,0,0,1,0.0,1,4,1,3,0,0,3,0
539,Marco Sportiello,ITA,GK,Atalanta,29,1992,5.0,0,0,0,0,0,0,0,,0,0,0,0,0,0,2,0
540,Luca Stanga,ITA,DF,Milan,19,2002,0.0,1,0,0,1,0,0,0,,0,0,0,0,0,1,0,0
541,Riccardo Stivanello,ITA,DF,Bologna,17,2004,0.5,1,1,1,0,0,1,1,100.0,0,2,2,0,0,1,6,0
542,Petar Stojanović,SVN,DF,Empoli,25,1995,30.4,96,63,55,32,9,59,114,51.8,55,39,13,26,27,123,65,1
543,Thomas Strakosha,ALB,GK,Lazio,26,1995,23.0,0,0,0,0,0,0,0,,0,0,0,0,0,0,7,2
544,Stefan Strandberg,NOR,DF,Salernitana,31,1990,10.4,13,8,10,3,0,8,11,72.7,3,15,13,2,9,22,49,0
545,Dávid Strelec,SVK,FW|MF,Spezia,20,2001,5.6,4,4,1,2,1,2,9,22.2,7,8,1,7,2,6,1,0
546,Kevin Strootman,NED,MF,Cagliari,31,1990,7.1,8,4,2,4,2,5,12,41.7,7,11,2,9,10,18,15,0
547,Jens Stryger Larsen,DEN,DF,Udinese,30,1991,7.6,5,2,3,1,1,2,3,66.7,1,2,0,2,4,9,17,0
548,Leo Štulac,SVN,MF,Empoli,26,1994,9.3,13,6,5,6,2,7,19,36.8,12,6,2,4,8,21,15,0
549,Stefano Sturaro,ITA,MF,Genoa,28,1993,19.6,43,26,16,16,11,22,48,45.8,26,25,1,24,15,58,29,2
550,Isaac Success,NGA,FW|MF,Udinese,25,1996,10.1,5,2,0,3,2,1,5,20.0,4,2,0,2,2,7,6,0
551,Vladyslav Supriaha,UKR,FW,Sampdoria,21,2000,0.2,0,0,0,0,0,0,1,0.0,1,0,0,0,0,0,0,0
552,Bosko Sutalo,CRO,DF,Hellas Verona,21,2000,10.2,20,13,11,6,3,8,16,50.0,8,10,5,5,17,37,39,0
553,Mattias Svanberg,SWE,MF,Bologna,22,1999,28.5,39,15,15,16,8,16,54,29.6,38,31,9,22,28,67,34,0
554,Michael Svoboda,AUT,DF,Venezia,22,1998,13.7,33,17,26,6,1,18,32,56.3,14,27,15,12,10,43,61,5
555,Wojciech Szczęsny,POL,GK,Juventus,31,1990,33.0,1,1,1,0,0,1,2,50.0,1,0,0,0,0,1,8,1
556,Adrien Tameze,CMR,MF|DF,Hellas Verona,27,1994,28.6,52,29,24,21,7,20,59,33.9,39,40,5,35,52,104,41,0
557,Ciprian Tătărușanu,ROU,GK,Milan,35,1986,6.0,0,0,0,0,0,0,1,0.0,1,0,0,0,0,0,2,1
558,Filippo Terracciano,ITA,DF,Hellas Verona,18,2003,0.1,0,0,0,0,0,0,0,,0,0,0,0,0,0,1,0
559,Pietro Terracciano,ITA,GK,Fiorentina,31,1990,31.8,0,0,0,0,0,0,4,0.0,4,0,0,0,2,2,20,1
560,Aleksa Terzić,SRB,DF,Fiorentina,21,1999,3.0,8,5,3,3,2,4,7,57.1,3,7,0,7,4,12,5,0
561,Tanner Tessmann,USA,MF,Venezia,19,2001,7.6,11,5,4,6,1,5,14,35.7,9,19,9,10,5,16,22,0
562,Arthur Theate,BEL,DF,Bologna,21,2000,26.9,33,19,26,3,4,14,31,45.2,17,29,16,13,42,75,69,0
563,Morten Thorsby,NOR,MF,Sampdoria,25,1996,32.7,46,26,15,23,8,28,56,50.0,28,37,12,25,25,71,39,0
564,Jeremy Toljan,GER,DF,Sassuolo,26,1994,15.5,18,10,12,4,2,13,20,65.0,7,12,5,7,12,30,41,0
565,Rafael Tolói,ITA,DF,Atalanta,30,1990,16.0,38,15,12,15,11,24,39,61.5,15,23,11,12,26,64,35,0
566,Takehiro Tomiyasu,JPN,DF,Bologna,22,1998,0.1,0,0,0,0,0,0,0,,0,1,0,1,1,1,0,0
567,Fikayo Tomori,ENG,DF,Milan,23,1997,30.2,73,44,36,34,3,18,26,69.2,8,37,23,14,45,118,84,1
568,Sandro Tonali,ITA,MF,Milan,21,2000,28.9,54,37,23,25,6,21,41,51.2,20,26,8,18,34,88,19,0
569,Lorenzo Tonelli,ITA,DF,Empoli,31,1990,9.7,17,9,11,4,2,6,13,46.2,7,14,8,6,19,36,28,2
570,Ernesto Torregrossa,VEN,FW,Sampdoria,29,1992,1.3,2,1,1,0,1,1,2,50.0,1,0,0,0,0,2,1,0
571,Lucas Torreira,URU,MF,Fiorentina,25,1996,24.4,37,29,13,21,3,18,40,45.0,22,18,1,17,26,63,18,0
572,Abdoulaye Touré,GUI,MF,Genoa,27,1994,4.8,12,4,3,8,1,5,11,45.5,6,6,1,5,4,16,6,0
573,Simone Trimboli,ITA,MF,Sampdoria,19,2002,0.7,2,1,2,0,0,2,2,100.0,0,0,0,0,2,4,0,0
574,Axel Tuanzebe,ENG,DF,Napoli,23,1997,0.1,0,0,0,0,0,0,0,,0,1,1,0,0,0,0,0
575,Destiny Udogie,ITA,DF,Udinese,18,2002,27.5,64,40,30,27,7,33,60,55.0,27,39,6,33,27,91,42,0
576,Maximilian Ullmann,AUT,DF,Venezia,25,1996,2.7,0,0,0,0,0,0,1,0.0,1,4,0,4,2,2,7,0
577,Kacper Urbanski,POL,MF,Bologna,16,2004,0.5,3,2,1,2,0,2,2,100.0,0,2,0,2,0,3,0,0
578,Antonio Vacca,ITA,MF,Venezia,31,1990,11.8,36,20,24,10,2,14,36,38.9,22,16,8,8,20,56,16,0
579,Zinho Vanheusden,BEL,DF,Genoa,22,1999,11.0,18,6,12,5,1,8,14,57.1,6,19,14,5,23,41,42,0
580,Johan Vásquez,MEX,DF,Genoa,22,1998,25.3,79,46,44,32,3,48,75,64.0,27,32,10,22,42,121,85,0
581,Denis Vavro,SVK,DF,Lazio,25,1996,0.1,0,0,0,0,0,0,0,,0,0,0,0,0,0,0,0
582,Matías Vecino,URU,MF,Inter,29,1991,4.2,7,5,2,3,2,3,9,33.3,6,10,1,9,4,11,7,0
583,Miguel Veloso,POR,MF,Hellas Verona,35,1986,14.9,23,15,4,17,2,10,16,62.5,6,18,5,13,11,34,18,1
584,Lorenzo Venuti,ITA,DF,Fiorentina,26,1995,17.5,25,10,13,10,2,14,24,58.3,10,13,4,9,5,30,27,0
585,Daniele Verde,ITA,FW|MF,Spezia,25,1996,21.7,11,4,8,2,1,9,20,45.0,11,17,2,15,18,29,8,0
586,Simone Verdi,ITA,MF|FW,Torino,29,1992,0.5,1,1,0,1,0,0,0,,0,0,0,0,0,1,0,0
587,Simone Verdi,ITA,FW|MF,Salernitana,29,1992,9.2,12,8,5,2,5,9,20,45.0,11,4,0,4,3,15,1,0
588,Jordan Veretout,FRA,MF,Roma,28,1993,25.8,34,25,20,12,2,15,39,38.5,24,12,1,11,27,61,22,1
589,Edoardo Vergani,ITA,FW|MF,Salernitana,20,2001,1.1,2,2,2,0,0,0,0,,0,2,2,0,0,2,2,0
590,Valerio Verre,ITA,MF|FW,Sampdoria,27,1994,4.7,7,5,1,4,2,4,9,44.4,5,7,0,7,0,7,5,0
591,Valerio Verre,ITA,MF,Empoli,27,1994,3.4,4,2,3,1,0,2,7,28.6,5,2,0,2,1,5,0,0
592,Freddie Veseli,ALB,DF,Salernitana,28,1992,6.6,7,2,4,3,0,5,6,83.3,1,10,5,5,4,11,19,0
593,Guglielmo Vicario,ITA,GK,Empoli,24,1996,38.0,1,1,1,0,0,1,1,100.0,0,1,0,1,1,2,21,1
594,Arturo Vidal,CHI,MF,Inter,34,1987,8.2,26,10,16,9,1,9,26,34.6,17,13,5,8,7,33,7,1
595,Ronaldo Vieira,ENG,MF,Sampdoria,23,1998,5.5,10,6,6,4,0,5,10,50.0,5,5,2,3,6,16,5,1
596,Luca Vignali,ITA,DF|MF,Spezia,25,1996,0.9,1,1,0,1,0,0,3,0.0,3,0,0,0,1,2,1,0
597,Emanuel Vignato,ITA,MF|DF,Bologna,20,2000,6.6,12,7,5,7,0,6,13,46.2,7,2,0,2,2,14,5,0
598,Matías Viña,URU,DF|FW,Roma,23,1997,17.4,46,30,27,14,5,29,59,49.2,30,26,3,23,25,71,33,0
599,Nicolas Viola,ITA,MF,Bologna,31,1989,1.1,2,2,1,1,0,1,2,50.0,1,1,1,0,0,2,1,0
600,Mattia Viti,ITA,DF,Empoli,19,2002,16.6,28,16,16,9,3,15,24,62.5,9,28,25,3,29,57,69,1
601,Dušan Vlahović,SRB,FW,Fiorentina,21,2000,20.6,5,0,0,2,3,2,11,18.2,9,6,2,4,1,6,16,0
602,Dušan Vlahović,SRB,FW,Juventus,21,2000,12.0,0,0,0,0,0,0,4,0.0,4,3,0,3,0,0,7,0
603,Mërgim Vojvoda,KVX,DF,Torino,26,1995,22.0,38,23,23,11,4,20,36,55.6,16,27,8,19,20,58,51,0
604,Cristian Volpato,ITA,FW|MF,Roma,17,2003,0.4,1,1,0,0,1,1,1,100.0,0,0,0,0,0,1,0,0
605,Stefan de Vrij,NED,DF,Inter,29,1992,26.8,38,29,22,16,0,12,17,70.6,5,17,8,9,32,70,52,0
606,Walace,BRA,MF,Udinese,26,1995,33.0,83,49,37,38,8,50,113,44.2,63,51,5,46,54,137,32,1
607,Sebastian Walukiewicz,POL,DF,Cagliari,21,2000,3.4,9,5,7,2,0,3,5,60.0,2,5,2,3,7,16,14,0
608,Magnus Warming,DEN,MF|FW,Torino,21,2000,0.6,1,1,0,1,0,0,0,,0,2,0,2,0,1,0,0
609,Kelvin Yeboah,ITA,FW|MF,Genoa,21,2000,9.4,14,7,5,7,2,9,19,47.4,10,22,1,21,1,15,7,0
610,Gerard Yepes,ESP,MF|DF,Sampdoria,18,2002,0.2,1,0,0,1,0,1,1,100.0,0,1,0,1,0,1,0,0
611,Maya Yoshida,JPN,DF,Sampdoria,32,1988,20.3,17,10,8,9,0,8,15,53.3,7,27,20,7,28,45,72,1
612,Mattia Zaccagni,ITA,MF,Hellas Verona,26,1995,2.0,3,1,1,0,2,1,2,50.0,1,1,0,1,4,7,0,0
613,Mattia Zaccagni,ITA,FW,Lazio,26,1995,20.8,33,16,10,13,10,11,19,57.9,8,17,2,15,20,53,5,0
614,Denis Zakaria,SUI,MF,Juventus,24,1996,6.6,11,7,3,6,2,3,11,27.3,8,16,3,13,11,22,7,0
615,Nicola Zalewski,POL,DF,Roma,19,2002,8.8,32,19,17,11,4,21,35,60.0,14,18,1,17,16,48,4,0
616,Andre-Frank Zambo Anguissa,CMR,MF,Napoli,25,1995,21.4,50,26,24,17,9,25,51,49.0,26,31,5,26,24,74,33,1
617,Nicolò Zaniolo,ITA,FW|MF,Roma,22,1999,21.9,24,15,0,15,9,6,28,21.4,22,19,0,19,7,31,6,0
618,Alessandro Zanoli,ITA,DF,Napoli,20,2000,5.1,10,7,6,3,1,3,5,60.0,2,2,1,1,4,14,16,0
619,Mattia Zanotti,ITA,DF,Inter,18,2003,0.1,1,0,1,0,0,0,1,0.0,1,0,0,0,0,1,0,0
620,Duván Zapata,COL,FW,Atalanta,30,1991,19.1,6,2,0,4,2,4,8,50.0,4,8,1,7,3,9,5,0
621,Gabriele Zappa,ITA,DF,Cagliari,21,1999,12.7,21,9,12,6,3,6,24,25.0,18,15,5,10,14,35,28,0
622,Davide Zappacosta,ITA,DF,Atalanta,29,1992,26.1,32,22,12,13,7,19,37,51.4,18,32,2,30,12,44,22,0
623,Simone Zaza,ITA,FW|DF,Torino,30,1991,1.4,2,2,1,1,0,1,1,100.0,0,3,0,3,0,2,3,0
624,Marvin Zeegelaar,NED,DF,Udinese,30,1990,7.1,15,11,6,8,1,5,14,35.7,9,12,4,8,12,27,22,1
625,Piotr Zieliński,POL,MF,Napoli,27,1994,23.2,19,12,5,9,5,6,21,28.6,15,13,2,11,8,27,4,0
626,David Zima,CZE,DF,Torino,20,2000,14.6,20,12,8,11,1,9,20,45.0,11,15,13,2,23,43,42,0
627,Jeroen Zoet,NED,GK,Spezia,30,1991,7.0,1,0,1,0,0,1,1,100.0,0,0,0,0,0,1,4,0
628,Nadir Zortea,ITA,DF|MF,Salernitana,22,1999,15.7,21,15,9,7,5,11,19,57.9,8,14,2,12,7,28,33,0
629,Petar Zovko,BIH,GK,Spezia,19,2002,0.3,0,0,0,0,0,0,0,,0,0,0,0,0,0,1,0
630,Szymon Żurkowski,POL,MF,Empoli,23,1997,25.6,58,33,24,21,13,29,68,42.6,39,43,10,33,35,93,32,1
631,Milan Đurić,BIH,FW,Salernitana,31,1990,24.1,1,1,0,1,0,1,3,33.3,2,6,1,5,2,3,32,0
632,Filip Đuričić,SRB,MF|FW,Sassuolo,29,1992,7.5,13,10,7,1,5,5,13,38.5,8,7,1,6,4,17,1,0
