Rk,Player,Nation,Pos,Squad,Age,Born,90s,Tackles Tkl,Tackles TklW,Tackles Def 3rd,Tackles Mid 3rd,Tackles Att 3rd,Challenges Tkl,Challenges Att,Challenges Tkl%,Challenges Lost,Blocks Blocks,Blocks Sh,Blocks Pass,Int,Tkl+Int,Clr,Err
1,Yunis Abdelhamid,MAR,DF,Reims,34,1987,37.0,82,50,47,33,2,39,52,75.0,13,65,27,38,64,146,116,1
2,Himad Abdelli,ALG,MF|FW,Angers,22,1999,23.7,64,38,22,32,10,31,67,46.3,36,30,1,29,28,92,15,0
3,Salis Abdul Samed,GHA,MF,Lens,22,2000,32.2,46,26,18,23,5,29,52,55.8,23,38,9,29,36,82,26,0
4,Laurent Abergel,FRA,MF,Lorient,29,1993,26.0,92,52,59,30,3,39,92,42.4,53,47,8,39,34,126,39,0
5,Matthis Abline,FRA,FW|MF,Auxerre,19,2003,9.0,4,2,0,3,1,0,5,0.0,5,6,1,5,1,5,1,0
6,Matthis Abline,FRA,FW|MF,Rennes,19,2003,1.2,1,1,0,0,1,1,1,100.0,0,1,0,1,2,3,1,0
7,Zakaria Aboukhlal,MAR,FW|MF,Toulouse,22,2000,27.5,33,23,13,9,11,14,45,31.1,31,18,1,17,22,55,23,0
8,Mohamed Achi,FRA,FW,Nantes,20,2002,0.4,1,1,1,0,0,1,1,100.0,0,0,0,0,0,1,0,0
9,Martin Adeline,FRA,MF|FW,Reims,18,2003,1.2,3,3,2,1,0,3,4,75.0,1,3,1,2,3,6,3,0
10,Emmanuel Agbadou,CIV,DF,Reims,25,1997,26.5,71,49,53,16,2,42,65,64.6,23,30,14,16,32,103,107,3
11,Lucien Agoume,FRA,MF,Troyes,20,2002,12.2,42,25,18,15,9,17,33,51.5,16,14,5,9,27,69,24,0
12,Ruben Aguilar,FRA,DF,Monaco,29,1993,13.0,19,9,7,7,5,8,22,36.4,14,13,1,12,18,37,28,1
13,Amar Ahmed,SWE,FW,Troyes,18,2004,0.2,1,1,0,1,0,0,1,0.0,1,0,0,0,1,2,0,0
14,Jean-Eudes Aholou,CIV,MF,Strasbourg,28,1994,14.4,34,20,10,20,4,12,31,38.7,19,25,0,25,24,58,15,0
15,Ludovic Ajorque,FRA,FW,Strasbourg,28,1994,8.6,5,4,1,4,0,3,9,33.3,6,3,1,2,2,7,7,0
16,Maghnes Akliouche,FRA,MF|FW,Monaco,20,2002,4.5,7,4,4,3,0,2,8,25.0,6,2,0,2,3,10,2,0
17,Doğan Alemdar,TUR,GK,Rennes,19,2002,4.5,0,0,0,0,0,0,0,,0,0,0,0,0,0,1,1
18,Jim Allevinah,GAB,DF|FW,Clermont Foot,27,1995,24.9,39,24,24,11,4,19,62,30.6,43,24,2,22,24,63,26,1
19,Mickaël Alphonse,GLP,DF,Ajaccio,33,1989,15.1,35,23,20,11,4,20,33,60.6,13,17,5,12,35,70,44,1
20,Ibrahim Amadou,FRA,DF|MF,Angers,29,1993,4.7,10,7,6,3,1,7,11,63.6,4,7,3,4,10,20,20,0
21,Ayoub Amraoui,MAR,DF|FW,Nice,18,2004,3.3,6,5,3,3,0,2,5,40.0,3,1,0,1,4,10,4,0
22,Benjamin André,FRA,MF,Lille,31,1990,32.4,128,74,51,60,17,65,121,53.7,56,50,8,42,47,175,60,0
23,Komnen Andrić,SRB,FW,Clermont Foot,27,1995,16.1,13,5,2,7,4,2,15,13.3,13,8,1,7,8,21,13,0
24,Houssem Aouar,ALG,MF,Lyon,24,1998,5.8,12,5,5,5,2,3,9,33.3,6,12,2,10,8,20,3,0
25,Adil Aouchiche,FRA,MF,Lorient,20,2002,2.8,5,2,3,1,1,1,9,11.1,8,1,0,1,4,9,1,0
26,Dennis Appiah,FRA,DF|MF,Nantes,30,1992,8.8,21,11,14,7,0,10,27,37.0,17,13,5,8,10,31,16,0
27,Stredair Appuah,FRA,DF|MF,Nantes,18,2004,0.7,2,1,0,2,0,0,0,,0,2,0,2,1,3,0,0
28,Taïryk Arconte,FRA,FW,Brest,18,2003,1.4,1,1,0,0,1,0,3,0.0,3,1,0,1,0,1,2,0
29,Mohamed El Arouch,FRA,MF,Lyon,18,2004,0.0,1,1,1,0,0,0,0,,0,0,0,0,0,1,0,0
30,Lorenz Assignon,TOG,DF,Rennes,22,2000,2.9,6,2,4,2,0,2,4,50.0,2,6,0,6,2,8,9,0
31,Youcef Atal,ALG,DF|MF,Nice,26,1996,8.7,38,22,18,15,5,23,32,71.9,9,9,0,9,14,52,13,0
32,Valentin Atangana Edoa,FRA,MF,Reims,16,2005,1.9,8,3,4,2,2,3,6,50.0,3,2,1,1,0,8,1,0
33,Mathias Autret,FRA,MF|FW,Auxerre,31,1991,14.3,22,10,10,10,2,7,16,43.8,9,14,2,12,12,34,13,0
34,Cédric Avinel,GLP,DF,Ajaccio,35,1986,19.9,13,7,8,5,0,8,12,66.7,4,20,13,7,15,28,91,1
35,Loïc Bade,FRA,DF,Rennes,22,2000,1.0,1,1,1,0,0,0,0,,0,0,0,0,1,2,3,0
36,Benoît Badiashile,FRA,DF,Monaco,21,2001,9.3,10,8,6,4,0,5,10,50.0,5,9,6,3,17,27,40,1
37,Eric Bailly,CIV,DF,Marseille,28,1994,6.0,13,10,6,6,1,7,7,100.0,0,15,12,3,12,25,18,1
38,Dénys Bain,FRA,DF,Auxerre,29,1993,1.4,4,3,3,1,0,1,2,50.0,1,2,1,1,2,6,4,0
39,Brandon Baiye,BEL,MF,Clermont Foot,21,2000,0.6,3,2,2,1,0,2,3,66.7,1,1,0,1,1,4,3,0
40,Cédric Bakambu,COD,MF,Marseille,31,1991,0.7,2,1,2,0,0,2,2,100.0,0,0,0,0,0,2,0,0
41,Thierno Balde,FRA,DF|MF,Troyes,20,2002,23.9,27,14,19,4,4,18,30,60.0,12,15,3,12,23,50,39,0
42,Carlos Baleba,CMR,MF,Lille,18,2004,5.3,13,11,2,9,2,9,14,64.3,5,13,3,10,1,14,3,2
43,Leonardo Balerdi,ARG,DF,Marseille,23,1999,29.3,57,37,43,12,2,32,45,71.1,13,48,29,19,63,120,91,1
44,Folarin Balogun,USA,FW,Reims,21,2001,33.3,9,5,1,5,3,2,20,10.0,18,20,1,19,3,12,15,0
45,Abdoulaye Bamba,CIV,DF,Angers,32,1990,15.2,22,12,15,5,2,16,19,84.2,3,7,3,4,18,40,38,0
46,Jonathan Bamba,CIV,FW,Lille,26,1996,30.9,37,17,12,14,11,14,45,31.1,31,36,1,35,22,59,14,0
47,Bradley Barcola,FRA,FW|MF,Lyon,19,2002,16.0,25,16,8,10,7,8,39,20.5,31,29,0,29,19,44,10,0
48,Melvin Bard,FRA,DF,Nice,21,2000,27.3,96,60,61,29,6,59,89,66.3,30,35,4,31,64,160,40,1
49,Ross Barkley,ENG,MF|FW,Nice,28,1993,10.7,16,9,7,4,5,7,13,53.8,6,7,2,5,8,24,6,0
50,Mickaël Barreto,FRA,MF,Ajaccio,31,1991,14.7,32,20,12,17,3,8,45,17.8,37,17,0,17,18,50,11,0
51,Cyrille Bayala,BFA,MF,Ajaccio,26,1996,22.3,53,37,16,20,17,23,47,48.9,24,20,3,17,25,78,21,0
52,Yanis Begraoui,MAR,FW|MF,Toulouse,21,2001,0.7,2,0,1,0,1,1,2,50.0,1,0,0,0,1,3,0,0
53,Alexis Beka Beka,FRA,MF|DF,Nice,21,2001,6.1,16,5,6,9,1,4,15,26.7,11,9,1,8,12,28,6,0
54,Jérémie Bela,ANG,DF|MF,Clermont Foot,29,1993,8.3,6,4,2,1,3,3,4,75.0,1,10,1,9,9,15,8,0
55,Reda Belahyane,FRA,MF,Nice,18,2004,2.0,8,6,5,3,0,3,5,60.0,2,5,1,4,2,10,0,0
56,Youcef Belaïli,ALG,MF|FW,Ajaccio,30,1992,12.8,18,10,3,9,6,8,20,40.0,12,10,1,9,5,23,4,0
57,Youcef Belaïli,ALG,FW|MF,Brest,30,1992,4.0,5,2,3,2,0,2,7,28.6,5,2,0,2,1,6,1,0
58,Haris Belkebla,ALG,MF,Brest,28,1994,29.5,80,48,35,40,5,44,85,51.8,41,32,6,26,52,132,21,3
59,Jean-Ricner Bellegarde,FRA,MF|FW,Strasbourg,24,1998,26.9,47,25,15,21,11,11,25,44.0,14,26,3,23,26,73,22,0
60,Jeanöel Belocian,FRA,DF,Rennes,17,2005,5.6,10,7,3,5,2,5,9,55.6,4,6,3,3,6,16,11,0
61,Eliesse Ben Seghir,FRA,FW|MF,Monaco,17,2005,11.7,18,10,4,12,2,4,12,33.3,8,18,1,17,4,22,1,0
62,Salim Ben Seghir,FRA,MF,Marseille,19,2003,0.0,0,0,0,0,0,0,0,,0,1,0,1,0,0,0,0
63,Wissam Ben Yedder,FRA,FW,Monaco,31,1990,23.5,16,9,2,5,9,4,13,30.8,9,15,0,15,4,20,0,0
64,Nabil Bentaleb,ALG,MF,Angers,27,1994,27.7,74,40,31,35,8,36,61,59.0,25,33,11,22,44,118,29,3
65,Patrick Berg,NOR,MF|FW,Lens,24,1997,0.3,0,0,0,0,0,0,1,0.0,1,0,0,0,1,1,0,0
66,Mitchell van Bergen,NED,FW|DF,Reims,22,1999,10.1,18,8,6,7,5,8,20,40.0,12,8,2,6,6,24,11,0
67,Quentin Bernard,FRA,DF,Auxerre,33,1989,7.0,9,7,4,2,3,7,15,46.7,8,9,1,8,15,24,17,0
68,Paul Bernardoni,FRA,GK,Angers,25,1997,27.0,2,0,2,0,0,2,3,66.7,1,1,0,1,1,3,12,1
69,Juan Bernat,ESP,DF|MF,Paris S-G,29,1993,18.3,32,16,18,9,5,21,39,53.8,18,11,2,9,9,41,22,1
70,Jason Berthomier,FRA,MF,Clermont Foot,32,1990,0.3,0,0,0,0,0,0,0,,0,0,0,0,0,0,0,0
71,El Bilal Touré,MLI,FW,Reims,20,2001,1.0,0,0,0,0,0,0,0,,0,2,0,2,0,0,1,0
72,Jean-Claude Billong,CMR,MF,Clermont Foot,28,1993,0.3,0,0,0,0,0,0,0,,0,1,1,0,1,1,0,0
73,Veljko Birmančević,SRB,FW|MF,Toulouse,24,1998,4.9,13,7,5,4,4,7,21,33.3,14,12,2,10,7,20,1,0
74,Marco Bizot,NED,GK,Brest,31,1991,37.0,0,0,0,0,0,0,1,0.0,1,1,0,1,0,0,24,4
75,Rubén Blanco,ESP,GK,Marseille,27,1995,5.5,0,0,0,0,0,0,0,,0,0,0,0,0,0,1,0
76,Ludovic Blas,FRA,MF|FW,Nantes,24,1997,31.3,47,30,17,19,11,17,49,34.7,32,26,1,25,19,66,8,0
77,Miha Blažič,SVN,DF,Angers,29,1993,22.0,8,6,8,0,0,7,15,46.7,8,25,19,6,22,30,80,1
78,Joaquín Blázquez,ARG,GK,Brest,21,2001,1.0,0,0,0,0,0,0,0,,0,0,0,0,0,0,2,0
79,Myron Boadu,NED,FW,Monaco,21,2001,3.3,3,3,0,2,1,1,7,14.3,6,1,0,1,0,3,1,0
80,Jérôme Boateng,GER,DF,Lyon,33,1988,4.8,3,0,2,1,0,2,6,33.3,4,8,5,3,6,9,16,0
81,Antonin Bobichon,FRA,MF,Angers,26,1995,0.2,0,0,0,0,0,0,0,,0,1,0,1,0,0,0,0
82,Quentin Boisgard,FRA,MF,Lorient,25,1997,2.0,6,2,1,4,1,3,4,75.0,1,3,1,2,4,10,2,0
83,Neto Borges,BRA,DF,Clermont Foot,25,1996,31.5,75,45,45,20,10,46,75,61.3,29,45,11,34,41,116,62,1
84,Kenji-Van Boto,MAD,DF,Auxerre,26,1996,2.0,3,2,2,0,1,2,4,50.0,2,0,0,0,1,4,3,0
85,Kouamé Botué,BFA,FW|MF,Ajaccio,19,2002,2.5,4,2,2,1,1,0,2,0.0,2,1,0,1,0,4,1,0
86,Badredine Bouanani,ALG,FW|MF,Nice,17,2004,9.6,13,9,2,7,4,7,14,50.0,7,4,0,4,1,14,2,0
87,Hicham Boudaoui,ALG,MF,Nice,22,1999,20.8,67,32,31,30,6,35,53,66.0,18,34,5,29,36,103,16,0
88,Franci Bouebari,FRA,DF,Strasbourg,18,2003,0.8,3,0,1,2,0,3,5,60.0,2,0,0,0,2,5,2,0
89,Sofiane Boufal,MAR,FW|MF,Angers,28,1993,9.3,14,9,7,4,3,3,14,21.4,11,6,0,6,5,19,1,0
90,Ismaëlben Boura,FRA,DF|FW,Lens,21,2000,1.0,6,4,4,2,0,5,6,83.3,1,2,1,1,2,8,3,0
91,Benjamin Bourigeaud,FRA,MF|FW,Rennes,28,1994,34.1,45,29,16,23,6,21,65,32.3,44,38,3,35,31,76,32,0
92,Bilal Brahimi,ALG,FW|MF,Nice,22,2000,8.9,8,5,2,5,1,1,7,14.3,6,4,0,4,4,12,0,0
93,Lilian Brassier,FRA,DF,Brest,22,1999,34.4,42,30,31,8,3,23,32,71.9,9,42,19,23,53,95,132,1
94,Andreas Bruus,DEN,DF|FW,Troyes,23,1999,18.1,12,6,9,3,0,8,20,40.0,12,13,2,11,17,29,24,0
95,Joe Bryan,ENG,MF|DF,Nice,28,1993,2.0,5,4,3,2,0,4,4,100.0,0,2,0,2,1,6,1,0
96,Adam Buksa,POL,FW|MF,Lens,26,1996,1.1,1,0,0,0,1,0,3,0.0,3,0,0,0,0,1,0,0
97,Maxime Busi,BEL,DF,Reims,22,1999,11.6,21,16,9,11,1,13,29,44.8,16,14,6,8,14,35,24,0
98,Marcin Bułka,POL,GK,Nice,22,1999,2.0,0,0,0,0,0,0,1,0.0,1,0,0,0,1,1,0,0
99,Rémy Cabella,FRA,MF|FW,Lille,32,1990,28.1,64,37,21,28,15,29,64,45.3,35,41,5,36,17,81,7,1
100,Jimmy Cabot,FRA,DF|MF,Lens,28,1994,5.7,20,12,10,8,2,12,26,46.2,14,5,0,5,4,24,12,0
101,Jens Cajuste,SWE,MF,Reims,22,1999,17.0,46,25,25,14,7,25,48,52.1,23,30,6,24,18,64,22,0
102,Duje Ćaleta-Car,CRO,DF,Marseille,25,1996,0.1,0,0,0,0,0,0,0,,0,0,0,0,0,0,1,0
103,Mahdi Camara,FRA,MF,Brest,24,1998,20.2,63,36,18,38,7,25,43,58.1,18,35,4,31,40,103,16,0
104,Mohamed Camara,MLI,MF,Monaco,22,2000,24.4,83,45,38,39,6,48,92,52.2,44,45,6,39,27,110,14,1
105,Ousmane Camara,GUI,FW|MF,Auxerre,20,2001,0.3,1,1,0,0,1,0,0,,0,0,0,0,0,1,0,0
106,Ousmane Camara,FRA,DF,Angers,19,2003,5.8,10,6,5,5,0,5,12,41.7,7,4,2,2,11,21,15,0
107,Axel Camblan,FRA,FW|MF,Brest,18,2003,0.8,2,2,1,1,0,0,1,0.0,1,0,0,0,0,2,0,0
108,Pierrick Capelle,FRA,MF|DF,Angers,35,1987,15.9,36,21,17,15,4,22,55,40.0,33,24,3,21,15,51,24,0
109,Maxence Caqueret,FRA,MF,Lyon,22,2000,30.7,87,54,27,38,22,43,109,39.4,66,45,3,42,39,126,27,0
110,Irvin Cardona,FRA,FW|MF,Brest,24,1997,2.6,2,0,1,1,0,0,3,0.0,3,3,0,3,2,4,2,0
111,Igor Carioca,BRA,DF,Lorient,25,1996,5.1,18,11,12,2,4,12,21,57.1,9,7,0,7,5,23,17,0
112,Matis Carvalho,POR,GK,Montpellier,23,1999,1.5,0,0,0,0,0,0,0,,0,0,0,0,1,1,0,0
113,Jean-Charles Castelletto,CMR,DF,Nantes,27,1995,28.5,43,26,29,12,2,22,36,61.1,14,35,22,13,58,101,90,0
114,Yoann Cathline,FRA,FW|MF,Lorient,20,2002,12.1,19,12,7,6,6,5,12,41.7,7,10,1,9,8,27,16,1
115,Maximiliano Caufriez,BEL,DF,Clermont Foot,25,1997,24.7,40,24,31,8,1,20,28,71.4,8,33,18,15,34,74,70,0
116,Fabien Centonze,FRA,DF,Nantes,26,1996,18.8,58,37,30,22,6,30,42,71.4,12,24,7,17,44,102,55,1
117,Florian Chabrolle,FRA,MF,Ajaccio,24,1998,3.7,6,4,1,5,0,2,4,50.0,2,3,0,3,7,13,2,0
118,El Chadaille Bitshiabu,FRA,DF,Paris S-G,17,2005,6.5,10,7,7,2,1,3,12,25.0,9,9,7,2,9,19,13,3
119,Fares Chaïbi,ALG,FW|MF,Toulouse,19,2002,26.0,31,18,8,15,8,17,50,34.0,33,38,5,33,19,50,36,1
120,Muhammed Cham,AUT,MF,Clermont Foot,21,2000,21.9,30,15,15,4,11,13,35,37.1,22,13,0,13,7,37,5,0
121,Gaëtan Charbonnier,FRA,FW|MF,Auxerre,33,1988,2.8,2,1,0,2,0,0,4,0.0,4,2,0,2,0,2,5,0
122,Brendan Chardonnet,FRA,DF,Brest,27,1994,27.7,45,27,27,18,0,20,38,52.6,18,40,19,21,63,108,86,1
123,Xavier Chavalerin,FRA,MF,Troyes,31,1991,27.0,82,50,39,30,13,27,71,38.0,44,31,8,23,41,123,24,0
124,Ivane Chegra,FRA,MF|FW,Ajaccio,18,2004,2.1,8,3,6,1,1,4,11,36.4,7,0,0,0,1,9,0,0
125,Rayan Cherki,FRA,MF|FW,Lyon,18,2003,20.8,14,8,2,5,7,8,23,34.8,15,6,0,6,5,19,1,0
126,Ilyes Cheti,ALG,DF,Angers,27,1995,2.3,6,4,4,0,2,5,8,62.5,3,5,1,4,4,10,7,0
127,Lucas Chevalier,FRA,GK,Lille,20,2001,32.0,2,1,2,0,0,2,2,100.0,0,1,0,1,2,4,7,2
128,Pedro Chirivella,ESP,MF,Nantes,25,1997,22.5,33,22,12,15,6,17,44,38.6,27,24,1,23,20,53,7,0
129,Joris Chotard,FRA,MF,Montpellier,20,2001,27.3,64,34,37,23,4,40,78,51.3,38,40,11,29,40,104,42,1
130,Yanis Cimignani,FRA,MF|DF,Ajaccio,20,2002,3.1,11,5,3,7,1,4,5,80.0,1,5,1,4,2,13,2,0
131,Souleymane Cissé,FRA,DF,Clermont Foot,19,2002,0.4,1,1,1,0,0,1,1,100.0,0,1,1,0,1,2,2,0
132,Alexis Claude-Maurice,FRA,FW,Nice,24,1998,0.7,3,2,2,1,0,3,3,100.0,0,0,0,0,2,5,1,0
133,Alexis Claude-Maurice,FRA,MF|FW,Lens,24,1998,6.7,14,9,5,8,1,6,16,37.5,10,6,0,6,2,16,1,0
134,Jonathan Clauss,FRA,DF,Marseille,29,1992,28.8,46,28,21,16,9,23,52,44.2,29,29,4,25,31,77,40,2
135,Marcus Coco,FRA,FW|MF,Nantes,26,1996,7.1,24,15,11,9,4,11,23,47.8,12,13,3,10,14,38,7,0
136,Alexandre Coeff,FRA,DF,Auxerre,30,1992,6.5,10,5,6,4,0,4,9,44.4,5,9,4,5,8,18,35,1
137,Abdu Conté,POR,DF,Troyes,24,1998,14.6,25,17,14,8,3,12,22,54.5,10,13,6,7,6,31,25,0
138,Sébastien Corchia,FRA,DF,Nantes,31,1990,8.7,16,6,10,2,4,11,22,50.0,11,9,3,6,14,30,21,0
139,David Pereira da Costa,POR,MF|FW,Lens,21,2001,15.6,13,7,1,10,2,7,19,36.8,12,19,1,18,11,24,6,0
140,Logan Costa,CPV,DF,Toulouse,21,2001,4.6,9,4,7,1,1,6,9,66.7,3,6,3,3,4,13,12,0
141,Nuno da Costa,CPV,FW|MF,Auxerre,31,1991,22.3,45,23,14,23,8,11,46,23.9,35,21,1,20,20,65,15,0
142,Benoît Costil,FRA,GK,Auxerre,35,1987,19.0,2,0,2,0,0,2,4,50.0,2,0,0,0,0,2,5,0
143,Mathieu Coutadeur,FRA,MF,Ajaccio,36,1986,21.6,23,13,13,10,0,8,28,28.6,20,19,3,16,19,42,21,0
144,Nicolas Cozza,FRA,DF,Montpellier,23,1999,14.2,38,21,27,9,2,26,38,68.4,12,11,5,6,21,59,35,1
145,Damien Da Silva,FRA,DF,Lyon,34,1988,3.8,8,7,5,3,0,3,3,100.0,0,4,3,1,5,13,12,0
146,Andréa Dacourt,FRA,MF,Nice,17,2005,0.0,0,0,0,0,0,0,0,,0,0,0,0,0,0,0,0
147,Colin Dagba,FRA,DF|MF,Strasbourg,23,1998,10.6,32,20,17,10,5,19,26,73.1,7,18,2,16,17,49,19,0
148,Thijs Dallinga,NED,FW,Toulouse,21,2000,26.1,8,6,2,2,4,1,13,7.7,12,17,3,14,3,11,20,0
149,Flavius Daniliuc,AUT,DF,Nice,21,2001,1.0,2,0,2,0,0,1,1,100.0,0,4,1,3,0,2,1,0
150,Kévin Danois,FRA,MF,Auxerre,18,2004,0.0,1,1,0,1,0,0,0,,0,0,0,0,1,2,0,0
151,Kevin Danso,AUT,DF,Lens,23,1998,35.9,37,19,25,11,1,19,30,63.3,11,48,34,14,33,70,124,0
152,Dante,BRA,DF,Nice,38,1983,36.7,70,40,45,21,4,36,59,61.0,23,52,31,21,47,117,125,2
153,Achraf Dari,MAR,DF,Brest,23,1999,14.6,21,14,15,5,1,14,20,70.0,6,16,10,6,19,40,65,2
154,Jonathan David,CAN,FW,Lille,22,2000,35.2,24,17,6,11,7,10,27,37.0,17,20,2,18,8,32,13,0
155,Thibault De Smet,BEL,DF,Reims,24,1998,19.5,24,17,10,14,0,11,37,29.7,26,28,5,23,20,44,40,1
156,Brecht Dejaegere,BEL,MF,Toulouse,31,1991,20.1,40,23,10,20,10,15,51,29.4,36,25,5,20,14,54,11,0
157,Romain Del Castillo,FRA,MF|FW,Brest,26,1996,15.8,39,24,13,17,9,16,36,44.4,20,14,1,13,11,50,5,0
158,Thomas Delaine,FRA,DF|MF,Strasbourg,30,1992,11.9,28,14,16,6,6,13,26,50.0,13,8,3,5,16,44,9,0
159,Sacha Delaye,FRA,FW|MF,Montpellier,20,2002,0.2,1,0,0,0,1,1,1,100.0,0,0,0,0,0,1,0,0
160,Andy Delort,ALG,FW,Nice,30,1991,8.7,2,0,1,1,0,1,2,50.0,1,0,0,0,1,3,7,0
161,Andy Delort,ALG,FW,Nantes,30,1991,5.2,5,4,1,2,2,2,6,33.3,4,3,0,3,0,5,2,0
162,Karamoko Dembele,SCO,FW|MF,Brest,19,2003,2.0,2,0,1,1,0,2,2,100.0,0,1,0,1,1,3,0,0
163,Moussa Dembélé,FRA,FW|MF,Lyon,26,1996,9.7,8,4,3,3,2,4,7,57.1,3,5,0,5,2,10,6,0
164,Siriki Dembélé,CIV,MF|FW,Auxerre,25,1996,4.1,10,6,4,3,3,4,12,33.3,8,2,0,2,1,11,2,0
165,Branco van den Boomen,NED,MF,Toulouse,27,1995,32.1,71,36,26,32,13,36,89,40.4,53,27,4,23,10,81,27,2
166,Rémy Descamps,FRA,GK,Nantes,26,1996,1.0,0,0,0,0,0,0,0,,0,0,0,0,0,0,0,0
167,Mikkel Desler,DEN,DF,Toulouse,27,1995,25.1,71,38,36,27,8,43,67,64.2,24,35,6,29,36,107,48,2
168,Mamadou Diakhon,FRA,FW,Reims,16,2005,0.2,2,0,2,0,0,0,1,0.0,1,1,0,1,1,3,0,0
169,Bafodé Diakité,FRA,DF,Lille,21,2001,29.5,54,35,23,24,7,32,57,56.1,25,37,8,29,17,71,58,0
170,Ibrahim Diakité,GUI,DF,Reims,18,2003,1.5,3,3,3,0,0,2,3,66.7,1,0,0,0,5,8,6,0
171,Baila Diallo,FRA,DF|MF,Clermont Foot,21,2001,1.0,1,0,1,0,0,0,0,,0,1,1,0,0,1,1,0
172,Habib Diallo,SEN,FW,Strasbourg,27,1995,32.0,18,10,8,7,3,6,16,37.5,10,19,4,15,12,30,26,0
173,Ismael Diallo,CIV,DF,Ajaccio,25,1997,24.2,46,33,35,9,2,35,63,55.6,28,26,12,14,30,76,46,1
174,Mouhamadou Diarra,FRA,MF|FW,Strasbourg,18,2004,18.1,24,16,10,11,3,15,29,51.7,14,17,1,16,11,35,13,0
175,Moussa Diarra,MLI,DF,Toulouse,21,2000,13.6,20,9,9,9,2,9,15,60.0,6,25,10,15,19,39,27,1
176,Stéphane Diarra,FRA,FW|MF,Lorient,23,1998,11.8,25,17,14,9,2,11,29,37.9,18,13,1,12,22,47,9,0
177,Krépin Diatta,SEN,MF|FW,Monaco,23,1999,23.0,30,21,4,17,9,13,32,40.6,19,29,1,28,17,47,12,0
178,Mory Diaw,SEN,GK,Clermont Foot,29,1993,37.0,0,0,0,0,0,0,4,0.0,4,0,0,0,2,2,13,5
179,Bamba Dieng,SEN,FW|MF,Marseille,22,2000,2.2,4,4,2,1,1,3,4,75.0,1,5,1,4,0,4,0,0
180,Bamba Dieng,SEN,FW,Lorient,22,2000,8.3,19,10,5,12,2,3,11,27.3,8,6,0,6,2,21,6,0
181,Tristan Dingomé,CMR,MF,Troyes,31,1991,1.1,1,1,0,1,0,0,2,0.0,2,0,0,0,0,1,0,0
182,Sinaly Diomande,CIV,DF,Lyon,21,2001,21.7,42,24,26,15,1,31,49,63.3,18,26,13,13,49,91,75,1
183,Lois Diony,FRA,FW,Angers,29,1992,5.6,1,0,0,1,0,1,3,33.3,2,2,0,2,0,1,1,0
184,Edan Diop,FRA,DF|FW,Monaco,17,2004,2.5,13,8,3,3,7,7,15,46.7,8,7,1,6,4,17,1,0
185,Sofiane Diop,FRA,MF|FW,Nice,22,2000,13.6,23,11,12,6,5,7,20,35.0,13,14,2,12,16,39,5,0
186,Sofiane Diop,FRA,MF,Monaco,22,2000,0.7,0,0,0,0,0,0,0,,0,0,0,0,1,1,0,0
187,Yehvann Diouf,FRA,GK,Reims,22,1999,31.0,2,0,2,0,0,1,3,33.3,2,0,0,0,1,3,13,5
188,Axel Disasi,FRA,DF,Monaco,24,1998,37.0,30,20,13,13,4,13,27,48.1,14,51,31,20,56,86,112,2
189,Tiago Djaló,POR,DF,Lille,22,2000,22.4,31,21,23,7,1,13,20,65.0,7,17,11,6,23,54,60,1
190,Alexander Djiku,GHA,DF,Strasbourg,27,1994,29.7,53,36,37,16,0,26,46,56.5,20,45,19,26,66,119,151,3
191,Moussa Djitte,SEN,FW,Ajaccio,22,1999,1.5,1,0,0,0,1,1,2,50.0,1,0,0,0,0,1,1,0
192,Ouparine Djoco,GNB,GK,Clermont Foot,24,1998,1.0,0,0,0,0,0,0,0,,0,0,0,0,0,0,1,0
193,Alan Do Marcolino,GAB,FW,Rennes,20,2002,0.2,0,0,0,0,0,0,0,,0,0,0,0,0,0,1,0
194,Jeremy Doku,BEL,MF|FW,Rennes,20,2002,14.3,25,16,6,13,6,12,24,50.0,12,10,0,10,5,30,2,0
195,Kyliane Dong,FRA,MF|FW,Troyes,17,2004,2.4,3,1,0,2,1,1,2,50.0,1,1,0,1,1,4,0,0
196,Jordan Dongmo,CMR,MF,Troyes,21,2001,0.2,1,0,0,1,0,1,1,100.0,0,0,0,0,0,1,0,0
197,Gianluigi Donnarumma,ITA,GK,Paris S-G,23,1999,37.9,1,0,1,0,0,1,2,50.0,1,0,0,0,0,1,12,4
198,Jodel Dossou,BEN,MF|DF,Clermont Foot,30,1992,2.9,7,4,3,2,2,4,4,100.0,0,2,1,1,1,8,0,0
199,Lohann Doucet,FRA,MF|FW,Nantes,19,2002,1.0,3,0,2,0,1,3,4,75.0,1,2,0,2,2,5,4,0
200,Ckene Doucouré,COM,FW|MF,Lorient,20,2002,1.5,2,2,2,0,0,1,2,50.0,1,0,0,0,1,3,0,0
201,Désiré Doué,FRA,MF|FW,Rennes,17,2005,12.4,37,18,10,23,4,13,32,40.6,19,17,1,16,13,50,3,0
202,Guela Doué,FRA,FW|MF,Rennes,19,2002,0.1,0,0,0,0,0,0,0,,0,0,0,0,0,0,0,0
203,Ismaël Doukouré,FRA,DF|MF,Strasbourg,19,2003,25.5,48,24,23,21,4,20,34,58.8,14,26,8,18,27,75,54,0
204,Kamory Doumbia,MLI,MF,Reims,19,2003,12.8,31,16,9,14,8,12,37,32.4,25,17,1,16,13,44,3,0
205,Souleyman Doumbia,CIV,DF|FW,Angers,25,1996,19.9,45,31,31,13,1,17,31,54.8,14,20,3,17,27,72,27,1
206,Rémy Dugimont,FRA,FW|MF,Auxerre,36,1986,1.3,2,1,0,1,1,1,2,50.0,1,3,0,3,0,2,5,0
207,Maxime Dupé,FRA,GK,Toulouse,29,1993,38.0,0,0,0,0,0,0,0,,0,0,0,0,0,0,9,3
208,Jean-Kevin Duverne,HAI,DF,Brest,25,1997,27.9,72,38,44,24,4,42,73,57.5,31,33,5,28,28,100,65,1
209,Hugo Ekitike,FRA,FW,Paris S-G,20,2002,12.8,12,4,1,10,1,4,12,33.3,8,12,0,12,9,21,3,0
210,Alberth Elis,HON,MF|FW,Brest,26,1996,2.9,4,3,1,2,1,1,7,14.3,6,1,0,1,1,5,2,0
211,Breel Embolo,SUI,FW,Monaco,25,1997,20.7,15,9,2,7,6,5,10,50.0,5,14,3,11,5,20,12,0
212,Maxime Estève,FRA,DF,Montpellier,20,2002,18.3,24,13,17,5,2,12,17,70.6,5,28,17,11,34,58,90,0
213,Fábio,BRA,DF|MF,Nantes,32,1990,2.5,4,2,1,2,1,4,6,66.7,2,2,0,2,3,7,11,0
214,Noah Fadiga,SEN,DF,Brest,22,1999,14.5,30,21,18,9,3,14,26,53.8,12,17,7,10,26,56,18,0
215,Wout Faes,BEL,DF,Reims,24,1998,3.0,1,1,1,0,0,1,2,50.0,1,6,3,3,7,8,19,0
216,Romain Faivre,FRA,MF|FW,Lorient,24,1998,13.8,13,8,5,4,4,5,25,20.0,20,11,0,11,1,14,4,0
217,Romain Faivre,FRA,MF,Lyon,24,1998,3.3,6,3,2,2,2,1,3,33.3,2,3,0,3,0,6,0,0
218,Fallou Fall,SEN,DF,Reims,18,2004,0.4,0,0,0,0,0,0,1,0.0,1,3,3,0,0,0,4,0
219,Khalil Fayad,FRA,MF,Montpellier,18,2004,8.0,30,14,12,16,2,12,21,57.1,9,8,1,7,9,39,4,0
220,Cheikh Faye,SEN,FW,Montpellier,23,1999,0.4,0,0,0,0,0,0,0,,0,0,0,0,1,1,0,0
221,Jordan Ferri,FRA,MF,Montpellier,30,1992,30.4,55,35,32,19,4,30,89,33.7,59,22,6,16,26,81,21,0
222,Karol Fila,POL,DF,Strasbourg,24,1998,0.5,0,0,0,0,0,0,0,,0,0,0,0,1,1,1,0
223,Alexis Flips,FRA,FW|MF,Reims,22,2000,22.0,51,30,18,17,16,27,64,42.2,37,35,5,30,24,75,12,0
224,Seko Fofana,CIV,MF,Lens,27,1995,34.1,28,13,8,18,2,15,39,38.5,24,17,4,13,19,47,14,0
225,Yahia Fofana,CIV,GK,Angers,21,2000,11.0,0,0,0,0,0,0,0,,0,0,0,0,1,1,4,1
226,Youssouf Fofana,FRA,MF,Monaco,23,1999,34.3,81,41,31,42,8,38,74,51.4,36,50,6,44,56,137,32,1
227,Thomas Foket,BEL,DF,Reims,27,1994,22.0,35,22,18,11,6,17,46,37.0,29,21,7,14,33,68,29,2
228,José Fonte,POR,DF,Lille,38,1983,28.8,23,17,18,4,1,10,21,47.6,11,27,14,13,25,48,112,2
229,Steven Fortes,CPV,DF,Lens,30,1992,0.1,0,0,0,0,0,0,0,,0,0,0,0,0,0,0,0
230,Przemysław Frankowski,POL,DF|MF,Lens,27,1995,31.5,77,51,37,31,9,39,80,48.8,41,38,6,32,41,118,42,2
231,Angelo Fulgini,FRA,MF|FW,Lens,25,1996,9.5,14,7,2,4,8,5,14,35.7,9,11,0,11,8,22,2,0
232,Gauthier Gallon,FRA,GK,Troyes,29,1993,29.6,2,2,2,0,0,2,4,50.0,2,0,0,0,2,4,17,0
233,Kévin Gameiro,FRA,FW,Strasbourg,35,1987,23.3,20,10,6,10,4,8,28,28.6,20,10,1,9,9,29,0,0
234,Ignatius Ganago,CMR,FW|MF,Nantes,23,1999,16.9,9,7,2,3,4,4,7,57.1,3,13,1,12,2,11,12,0
235,Ignatius Ganago,CMR,FW,Lens,23,1999,0.7,0,0,0,0,0,0,0,,0,0,0,0,0,0,1,0
236,Johan Gastien,FRA,MF,Clermont Foot,34,1988,28.9,62,34,30,23,9,38,111,34.2,73,37,7,30,36,98,25,1
237,Denis Genreau,AUS,MF,Toulouse,23,1999,7.3,35,13,16,12,7,13,31,41.9,18,16,1,15,8,43,9,0
238,Valère Germain,FRA,FW|MF,Montpellier,32,1990,7.6,13,11,3,5,5,4,12,33.3,8,8,0,8,6,19,12,0
239,Gerson,BRA,MF,Marseille,25,1997,4.6,6,4,1,4,1,3,5,60.0,2,5,0,5,2,8,4,0
240,Ismaël Gharbi,ESP,MF|FW,Paris S-G,18,2004,0.6,0,0,0,0,0,0,2,0.0,2,2,0,2,3,3,0,0
241,Faouzi Ghoulam,ALG,DF,Angers,31,1991,5.3,3,3,1,1,1,3,5,60.0,2,4,2,2,4,7,12,1
242,Samuel Gigot,FRA,DF,Marseille,28,1993,20.9,46,24,22,21,3,12,15,80.0,3,24,7,17,45,91,85,1
243,Andrei Girotto,BRA,DF|MF,Nantes,30,1992,35.0,122,73,71,45,6,74,132,56.1,58,55,24,31,73,195,176,1
244,Aleksandr Golovin,RUS,MF|FW,Monaco,26,1996,27.4,62,36,19,32,11,28,72,38.9,44,28,1,27,37,99,10,0
245,André Gomes,POR,MF,Lille,29,1993,18.1,37,19,12,17,8,19,52,36.5,33,20,5,15,9,46,16,1
246,Angel Gomes,ENG,MF,Lille,21,2000,31.3,41,19,12,21,8,18,49,36.7,31,22,2,20,13,54,11,1
247,Maxime Gonalons,FRA,MF,Clermont Foot,33,1989,16.1,52,32,25,21,6,25,53,47.2,28,21,1,20,20,72,7,1
248,Oumar Gonzalez,CMR,DF,Ajaccio,24,1998,28.6,51,28,34,13,4,23,37,62.2,14,32,11,21,52,103,82,0
249,Amine Gouiri,ALG,FW|MF,Nice,22,2000,2.5,1,1,1,0,0,0,1,0.0,1,1,0,1,0,1,3,0
250,Amine Gouiri,ALG,FW|MF,Rennes,22,2000,28.0,42,25,14,16,12,14,33,42.4,19,21,0,21,12,54,10,0
251,Jonathan Gradit,FRA,DF,Lens,29,1992,31.4,62,40,30,25,7,31,53,58.5,22,40,26,14,38,100,83,0
252,Andrew Gravillon,GLP,DF,Reims,24,1998,11.5,16,8,9,6,1,8,13,61.5,5,18,9,9,21,37,36,0
253,Adrian Grbić,AUT,MF|FW,Lorient,25,1996,0.3,0,0,0,0,0,0,1,0.0,1,3,0,3,0,0,0,0
254,Gabriel Gudmundsson,SWE,DF|FW,Lille,23,1999,9.3,19,11,7,10,2,12,22,54.5,10,11,2,9,10,29,20,0
255,Axel Gueguin,FRA,FW|MF,Montpellier,17,2005,0.3,0,0,0,0,0,0,0,,0,1,0,1,0,0,0,0
256,Mattéo Guendouzi,FRA,MF,Marseille,23,1999,23.4,39,18,9,21,9,14,38,36.8,24,12,5,7,21,60,18,0
257,Evann Guessand,FRA,FW|MF,Nantes,21,2001,14.0,24,16,8,13,3,6,12,50.0,6,17,1,16,9,33,6,0
258,Pape Gueye,SEN,MF|DF,Marseille,23,1999,5.5,18,7,10,7,1,7,15,46.7,8,9,2,7,9,27,2,0
259,Frederic Guilbert,FRA,DF,Strasbourg,27,1994,16.2,47,29,18,23,6,25,43,58.1,18,24,3,21,43,90,33,1
260,Serhou Guirassy,GUI,MF,Rennes,26,1996,0.3,0,0,0,0,0,0,0,,0,0,0,0,0,0,0,0
261,Rafik Guitane,FRA,FW,Reims,23,1999,0.0,0,0,0,0,0,0,0,,0,0,0,0,0,0,1,0
262,Malo Gusto,FRA,DF,Lyon,19,2003,17.7,42,26,23,11,8,21,43,48.8,22,22,5,17,28,70,23,1
263,Jaouen Hadjam,ALG,DF,Nantes,19,2003,8.9,27,21,13,9,5,16,25,64.0,9,10,3,7,12,39,12,0
264,Massadio Haïdara,MLI,DF|MF,Lens,29,1992,18.6,24,16,9,9,6,12,24,50.0,12,26,9,17,36,60,39,1
265,Achraf Hakimi,MAR,DF|MF,Paris S-G,23,1998,22.8,54,34,19,20,15,31,59,52.5,28,34,2,32,16,70,19,0
266,Mathis Hamdi,FRA,DF,Troyes,18,2003,0.8,0,0,0,0,0,0,1,0.0,1,0,0,0,1,1,1,0
267,Ben Hamed Touré,CIV,FW,Ajaccio,18,2003,2.3,4,4,2,2,0,1,5,20.0,4,2,0,2,1,5,4,0
268,Romain Hamouma,FRA,FW|MF,Ajaccio,35,1987,12.0,8,3,3,3,2,3,6,50.0,3,8,0,8,2,10,2,0
269,Saïd Hamulic,BIH,FW,Toulouse,21,2000,1.2,0,0,0,0,0,0,0,,0,0,0,0,0,0,0,0
270,Amine Harit,MAR,MF|FW,Marseille,25,1997,5.7,6,4,0,3,3,3,8,37.5,5,4,1,3,4,10,6,0
271,Rhys Healey,WAL,FW,Toulouse,27,1994,0.7,0,0,0,0,0,0,0,,0,0,0,0,0,0,0,0
272,Gauthier Hein,FRA,MF|FW,Auxerre,25,1996,20.8,27,20,13,11,3,18,48,37.5,30,10,0,10,6,33,10,0
273,Henrique,BRA,DF|FW,Lyon,28,1994,4.0,9,4,3,2,4,6,13,46.2,7,3,1,2,5,14,8,0
274,Christophe Hérelle,MTQ,DF,Brest,29,1992,11.8,10,4,7,2,1,4,13,30.8,9,16,11,5,20,30,48,0
275,Noah Holm,NOR,FW|MF,Reims,21,2001,2.2,6,4,2,2,2,2,5,40.0,3,0,0,0,0,6,5,0
276,Franck Honorat,FRA,FW|MF,Brest,25,1996,28.2,41,29,20,8,13,19,34,55.9,15,22,2,20,21,62,18,0
277,Cédric Hountondji,BEN,DF,Angers,28,1994,34.4,50,36,31,17,2,19,29,65.5,10,44,22,22,59,109,132,1
278,Ilyes Housni,FRA,FW,Paris S-G,17,2005,0.1,1,1,1,0,0,1,1,100.0,0,0,0,0,0,1,0,0
279,Adrien Hunou,FRA,MF|FW,Angers,28,1994,24.8,39,20,17,16,6,16,45,35.6,29,35,0,35,7,46,7,0
280,Mounaim El Idrissy,FRA,FW,Ajaccio,23,1999,27.7,32,19,5,20,7,10,36,27.8,26,22,0,22,13,45,20,0
281,Rareş Ilie,ROU,MF|FW,Nice,19,2003,1.6,3,3,0,1,2,2,4,50.0,2,2,0,2,1,4,1,0
282,Bonke Innocent,NGA,MF,Lorient,26,1996,13.1,28,17,13,14,1,11,36,30.6,25,22,5,17,26,54,31,0
283,Ismaily,BRA,DF,Lille,32,1990,19.8,41,18,16,16,9,17,32,53.1,15,25,5,20,21,62,39,0
284,Junya Ito,JPN,FW,Reims,29,1993,32.4,40,20,14,15,11,13,53,24.5,40,29,1,28,8,48,4,1
285,Ismail Jakobs,SEN,DF|FW,Monaco,22,1999,12.4,11,5,7,3,1,5,12,41.7,7,9,1,8,9,20,18,0
286,Marin Jakoliš,CRO,FW,Angers,25,1996,0.3,1,1,0,0,1,0,0,,0,0,0,0,0,1,0,0
287,Léo Jardim,BRA,GK,Lille,27,1995,6.0,0,0,0,0,0,0,1,0.0,1,0,0,0,0,0,0,1
288,Luis Javier Suárez,COL,FW,Marseille,24,1997,3.3,4,1,1,2,1,1,4,25.0,3,1,0,1,3,7,6,0
289,Dany Jean,HAI,DF|MF,Strasbourg,19,2002,0.1,0,0,0,0,0,0,1,0.0,1,1,0,1,0,0,0,0
290,Julian Jeanvier,GUI,DF,Auxerre,30,1992,19.6,32,17,24,8,0,13,22,59.1,9,24,17,7,27,59,96,1
291,Jefferson,BRA,FW,Lyon,22,1999,5.0,17,4,4,9,4,6,15,40.0,9,6,0,6,1,18,0,0
292,Paul Joly,FRA,DF,Auxerre,22,2000,9.6,33,21,21,10,2,19,35,54.3,16,13,2,11,24,57,29,2
293,Jubal,BRA,DF,Auxerre,28,1993,35.7,41,26,29,11,1,19,38,50.0,19,57,34,23,53,94,193,0
294,Christopher Jullien,FRA,DF,Montpellier,29,1993,29.9,46,28,29,14,3,28,51,54.9,23,35,18,17,43,89,114,1
295,Eli Junior Kroupi,FRA,FW|MF,Lorient,16,2006,0.1,0,0,0,0,0,0,1,0.0,1,0,0,0,1,1,0,0
296,Issa Kaboré,BFA,DF,Marseille,21,2001,11.4,33,19,10,18,5,21,32,65.6,11,11,1,10,12,45,21,1
297,Abdoul Kader Bamba,FRA,FW|MF,Nantes,28,1994,0.9,0,0,0,0,0,0,2,0.0,2,3,1,2,0,0,1,0
298,Gaël Kakuta,COD,FW,Lens,31,1991,0.2,0,0,0,0,0,0,0,,0,0,0,0,0,0,1,0
299,Arnaud Kalimuendo,FRA,FW,Rennes,20,2002,20.5,15,8,3,6,6,5,20,25.0,15,15,2,13,2,17,9,0
300,Gedeon Kalulu,COD,DF,Lorient,24,1997,27.1,64,34,43,14,7,30,48,62.5,18,32,3,29,28,92,79,2
301,Justin-Noël Kalumba,FRA,DF,Angers,17,2004,6.1,9,5,5,2,2,5,16,31.3,11,4,1,3,4,13,5,0
302,Waren Kamanzi,NOR,DF,Toulouse,21,2000,7.4,16,9,9,5,2,13,19,68.4,6,8,2,6,8,24,9,0
303,Bingourou Kamara,SEN,GK,Montpellier,25,1996,4.5,0,0,0,0,0,0,0,,0,0,0,0,0,0,2,0
304,Nordine Kandil,FRA,MF|FW,Strasbourg,20,2001,1.1,3,2,1,2,0,0,3,0.0,3,2,0,2,1,4,1,0
305,Ayman Kari,FRA,MF|DF,Lorient,17,2004,1.1,0,0,0,0,0,0,0,,0,4,0,4,3,3,0,0
306,Kévin Keben Biakolo,CMR,DF,Toulouse,18,2004,4.0,3,2,2,0,1,0,4,0.0,4,1,0,1,5,8,9,0
307,Check Keita,FRA,DF,Reims,19,2003,7.6,12,9,9,3,0,4,9,44.4,5,6,5,1,5,17,24,1
308,Saîf-Eddine Khaoui,TUN,MF,Clermont Foot,27,1995,22.5,47,28,14,25,8,15,47,31.9,32,17,2,15,33,80,8,0
309,Wahbi Khazri,TUN,FW|MF,Montpellier,31,1991,18.2,26,13,13,7,6,6,25,24.0,19,17,1,16,9,35,20,0
310,Anthony Khelifa,FRA,DF,Ajaccio,16,2005,0.1,0,0,0,0,0,0,0,,0,0,0,0,0,0,0,0
311,Presnel Kimpembe,FRA,DF,Paris S-G,26,1995,8.1,17,8,9,6,2,9,13,69.2,4,12,7,5,13,30,9,1
312,Samuel Koeberlé,FRA,MF,Reims,17,2004,0.0,0,0,0,0,0,0,0,,0,0,0,0,0,0,0,0
313,Rudy Kohon,FRA,DF,Troyes,18,2004,0.7,4,3,4,0,0,2,2,100.0,0,1,0,1,1,5,2,0
314,Sead Kolašinac,BIH,DF,Marseille,29,1993,24.6,52,36,24,22,6,24,37,64.9,13,19,2,17,43,95,35,1
315,Cheick Konaté,CIV,DF,Clermont Foot,18,2004,6.4,19,12,10,7,2,13,22,59.1,9,7,1,6,13,32,8,1
316,Ibrahima Koné,MLI,FW,Lorient,23,1999,17.5,24,13,3,13,8,5,11,45.5,6,13,0,13,4,28,18,0
317,Youssouf Koné,MLI,DF,Ajaccio,27,1995,10.2,28,19,24,4,0,18,25,72.0,7,9,2,7,12,40,32,1
318,Rominigue Kouamé,MLI,MF,Troyes,25,1996,29.6,44,27,28,14,2,17,41,41.5,24,32,11,21,49,93,46,1
319,Boubakar Kouyaté,MLI,DF,Montpellier,25,1997,14.0,31,18,18,11,2,19,35,54.3,16,24,14,10,34,65,73,1
320,Sael Kumbedi,FRA,DF,Lyon,17,2005,14.7,47,27,27,13,7,20,38,52.6,18,23,7,16,10,57,16,0
321,Grejohn Kyei,FRA,FW,Clermont Foot,26,1995,24.8,16,7,2,9,5,4,13,30.8,9,14,3,11,6,22,22,0
322,Rémy Labeau Lascary,GLP,FW|MF,Lens,19,2003,1.4,4,2,4,0,0,0,0,,0,4,0,4,1,5,0,0
323,Gaëtan Laborde,FRA,FW,Nice,28,1994,27.8,45,25,13,17,15,18,40,45.0,22,27,2,25,9,54,13,0
324,Gaëtan Laborde,FRA,FW,Rennes,28,1994,2.8,1,1,1,0,0,0,1,0.0,1,1,0,1,0,1,1,0
325,Alexandre Lacazette,FRA,FW,Lyon,31,1991,32.5,43,23,7,17,19,10,29,34.5,19,23,3,20,15,58,4,0
326,Qazim Laçi,ALB,MF,Ajaccio,26,1996,2.4,6,3,2,3,1,4,9,44.4,5,5,0,5,2,8,3,0
327,Alban Lafont,FRA,GK,Nantes,23,1999,37.0,0,0,0,0,0,0,1,0.0,1,0,0,0,0,0,20,4
328,Kenny Lala,FRA,DF,Brest,30,1991,15.7,36,19,19,15,2,22,38,57.9,16,15,5,10,21,57,28,0
329,Mohamed Lamine Bayo,GUI,FW|MF,Lille,24,1998,7.2,3,3,0,2,1,0,12,0.0,12,3,1,2,0,3,1,0
330,Julien Laporte,FRA,DF,Lorient,28,1993,18.4,22,16,18,3,1,16,22,72.7,6,33,27,6,18,40,108,2
331,Yasser Larouci,ALG,DF|MF,Troyes,21,2001,20.0,23,13,13,8,2,15,24,62.5,9,15,1,14,26,49,46,0
332,Armand Lauriente,FRA,FW,Lorient,23,1998,3.0,8,7,3,4,1,3,7,42.9,4,5,1,4,4,12,1,0
333,Théo Le Bris,FRA,MF|DF,Lorient,19,2002,16.1,31,19,17,11,3,15,33,45.5,18,21,2,19,18,49,31,0
334,Julien Le Cardinal,FRA,DF,Lens,24,1997,1.8,6,4,5,0,1,4,6,66.7,2,3,0,3,2,8,5,0
335,Jérémy Le Douaron,FRA,MF|FW,Brest,24,1998,23.0,15,9,5,9,1,3,27,11.1,24,29,2,27,11,26,30,0
336,Enzo Le Fée,FRA,MF,Lorient,22,2000,33.6,108,64,52,40,16,43,113,38.1,70,50,5,45,34,142,38,1
337,Vincent Le Goff,FRA,DF,Lorient,32,1989,37.0,75,32,56,16,3,45,62,72.6,17,29,9,20,41,116,105,1
338,Maxime Le Marchand,FRA,DF,Strasbourg,32,1989,22.4,39,24,23,14,2,19,31,61.3,12,22,14,8,37,76,74,0
339,Paolo Lebas,FRA,MF,Ajaccio,19,2003,0.6,0,0,0,0,0,0,0,,0,0,0,0,0,0,0,0
340,Jean-Louis Leca,FRA,GK,Lens,36,1985,1.0,0,0,0,0,0,0,0,,0,0,0,0,0,0,0,1
341,Benjamin Lecomte,FRA,GK,Montpellier,31,1991,19.0,0,0,0,0,0,0,2,0.0,2,0,0,0,0,0,6,0
342,Pierre Lees-Melou,FRA,MF,Brest,29,1993,30.7,97,55,55,37,5,57,123,46.3,66,48,13,35,52,149,46,1
343,Félix Lemaréchal,FRA,MF,Brest,18,2003,3.2,5,5,2,1,2,0,3,0.0,3,6,0,6,1,6,2,0
344,Mario Lemina,GAB,MF|DF,Nice,28,1993,9.3,32,21,11,14,7,12,18,66.7,6,13,5,8,11,43,20,0
345,Donovan Léon,GUF,GK,Auxerre,29,1992,2.0,0,0,0,0,0,0,0,,0,0,0,0,0,0,1,0
346,Johann Lepenant,FRA,MF,Lyon,19,2002,21.5,58,34,24,27,7,32,86,37.2,54,29,5,24,28,86,17,3
347,Benjamin Leroy,FRA,GK,Ajaccio,33,1989,31.1,0,0,0,0,0,0,2,0.0,2,0,0,0,1,1,16,2
348,Léo Leroy,FRA,MF,Montpellier,22,2000,13.2,53,38,24,26,3,31,57,54.4,26,25,2,23,14,67,8,0
349,Alexandre Letellier,FRA,GK,Paris S-G,31,1990,0.1,0,0,0,0,0,0,0,,0,0,0,0,0,0,0,0
350,Ruan Levine,BRA,MF|FW,Ajaccio,23,1999,0.3,2,2,1,1,0,0,0,,0,1,0,1,2,4,0,0
351,Dimitri Liénard,FRA,DF|MF,Strasbourg,34,1988,17.1,46,29,20,18,8,34,57,59.6,23,28,4,24,16,62,24,0
352,Mateusz Lis,POL,GK,Troyes,25,1997,8.3,0,0,0,0,0,0,1,0.0,1,1,0,1,0,0,3,0
353,Bradley Locko,FRA,DF,Reims,20,2002,11.8,31,16,21,4,6,15,27,55.6,12,17,4,13,20,51,21,0
354,Bradley Locko,FRA,DF,Brest,20,2002,3.0,4,3,2,1,1,2,3,66.7,1,4,0,4,2,6,13,0
355,Anthony Lopes,POR,GK,Lyon,31,1990,31.3,1,0,1,0,0,1,4,25.0,3,0,0,0,3,4,10,0
356,Rony Lopes,POR,MF|FW,Troyes,26,1995,26.1,24,12,6,15,3,7,31,22.6,24,14,2,12,9,33,10,0
357,Pau López,ESP,GK,Marseille,27,1994,32.5,0,0,0,0,0,0,1,0.0,1,0,0,0,0,0,5,1
358,Dion Lopy,SEN,MF,Reims,20,2002,15.3,45,24,22,16,7,23,62,37.1,39,27,3,24,22,67,18,0
359,Jordan Lotomba,SUI,DF,Nice,23,1998,27.3,65,38,33,24,8,31,48,64.6,17,38,11,27,32,97,53,0
360,Dejan Lovren,CRO,DF,Lyon,33,1989,16.2,25,19,20,5,0,20,29,69.0,9,20,10,10,26,51,70,1
361,Jean Lucas,BRA,MF,Monaco,24,1998,3.2,9,5,3,5,1,6,12,50.0,6,2,1,1,4,13,2,0
362,Castello Lukeba,FRA,DF,Lyon,19,2002,33.2,39,23,27,8,4,21,31,67.7,10,42,24,18,75,114,105,1
363,Youssouf M'Changama,COM,MF,Auxerre,31,1990,12.0,22,11,7,12,3,7,13,53.8,6,6,0,6,15,37,6,1
364,Deiver Machado,COL,DF|MF,Lens,28,1993,24.3,45,26,18,20,7,21,34,61.8,13,21,4,17,21,66,27,0
365,Soungoutou Magassa,FRA,MF,Monaco,18,2003,0.9,4,1,2,2,0,2,4,50.0,2,3,0,3,1,5,1,0
366,Hugo Magnetti,FRA,MF,Brest,24,1998,18.8,43,27,18,23,2,23,63,36.5,40,21,1,20,25,68,12,0
367,Yohann Magnin,FRA,MF,Clermont Foot,25,1997,26.7,89,54,37,45,7,54,106,50.9,52,50,12,38,25,114,46,0
368,Lovro Majer,CRO,MF|FW,Rennes,24,1998,18.5,34,23,16,13,5,8,29,27.6,21,21,1,20,21,55,5,1
369,Jean-Victor Makengo,FRA,MF,Lorient,24,1998,11.8,16,8,5,10,1,6,20,30.0,14,8,5,3,10,26,13,1
370,Béni Makouana,CGO,FW|MF,Montpellier,19,2002,2.2,1,0,0,1,0,0,2,0.0,2,3,1,2,0,1,1,0
371,Ruslan Malinovskyi,UKR,MF|FW,Marseille,29,1993,13.6,21,11,3,12,6,10,26,38.5,16,13,1,12,3,24,9,0
372,Hianga Mananga Mbock,FRA,MF,Brest,22,1999,0.2,0,0,0,0,0,0,1,0.0,1,0,0,0,0,0,0,0
373,Steve Mandanda,FRA,GK,Rennes,37,1985,33.5,0,0,0,0,0,0,2,0.0,2,0,0,0,0,0,9,3
374,Thomas Mangani,FRA,MF,Ajaccio,35,1987,14.8,32,17,14,15,3,18,47,38.3,29,22,3,19,24,56,22,1
375,Vito Mannone,ITA,GK,Lorient,34,1988,17.9,0,0,0,0,0,0,0,,0,0,0,0,0,0,4,3
376,Myziane Maolida,COM,MF|FW,Reims,23,1999,2.6,8,3,2,5,1,5,12,41.7,7,1,0,1,2,10,0,0
377,Faitout Maouassa,FRA,FW|DF,Montpellier,24,1998,21.4,52,32,26,20,6,18,41,43.9,23,31,3,28,20,72,23,0
378,Vincent Marchetti,FRA,MF,Ajaccio,25,1997,27.2,55,26,29,19,7,25,68,36.8,43,23,3,20,19,74,31,0
379,Guillermo Maripán,CHI,DF,Monaco,28,1994,24.0,46,26,26,20,0,17,33,51.5,16,39,27,12,38,84,87,0
380,Marquinhos,BRA,DF,Paris S-G,28,1994,30.2,33,25,18,12,3,18,26,69.2,8,43,27,16,23,56,83,2
381,Jonas Martin,FRA,MF,Lille,32,1990,3.1,9,7,4,5,0,5,14,35.7,9,3,1,2,7,16,3,0
382,Gelson Martins,POR,MF|FW,Monaco,27,1995,3.8,15,8,6,4,5,4,13,30.8,9,4,1,3,3,18,2,0
383,Han-Noah Massengo,FRA,MF,Auxerre,21,2001,12.4,27,15,10,15,2,7,16,43.8,9,12,3,9,14,41,7,0
384,Yanis Massolin,FRA,MF,Clermont Foot,19,2002,0.7,2,1,1,0,1,0,1,0.0,1,1,0,1,2,4,0,0
385,Eliot Matazo,BEL,MF,Monaco,20,2002,13.1,26,12,11,13,2,11,26,42.3,15,18,4,14,15,41,11,1
386,Chrislain Matsima,FRA,DF|MF,Lorient,20,2002,2.5,0,0,0,0,0,0,0,,0,3,3,0,2,2,7,0
387,Chrislain Matsima,FRA,DF,Monaco,20,2002,5.0,11,6,7,2,2,4,7,57.1,3,5,5,0,9,20,16,0
388,Jean Mattéo Bahoya,FRA,FW|MF,Angers,17,2005,3.0,7,3,1,3,3,4,7,57.1,3,4,0,4,0,7,0,0
389,Azor Matusiwa,NED,MF,Reims,24,1998,27.6,66,41,30,29,7,36,61,59.0,25,37,11,26,46,112,52,0
390,Aïman Maurer,MAR,MF,Clermont Foot,17,2004,5.6,2,1,1,1,0,1,10,10.0,9,1,0,1,3,5,5,0
391,Stephy Mavididi,ENG,FW,Montpellier,24,1998,14.3,24,19,12,8,4,13,27,48.1,14,21,1,20,4,28,10,0
392,Christian Mawissa,FRA,DF,Toulouse,17,2005,1.1,2,0,1,1,0,1,3,33.3,2,0,0,0,3,5,1,0
393,Fernand Mayembo,CGO,DF,Ajaccio,26,1996,7.9,8,5,6,2,0,4,9,44.4,5,2,0,2,11,19,36,0
394,Derek Mazou-Sacko,FRA,MF,Troyes,17,2004,0.2,0,0,0,0,0,0,1,0.0,1,1,0,1,1,1,1,0
395,Kylian Mbappé,FRA,FW,Paris S-G,23,1998,31.3,10,4,0,5,5,5,16,31.3,11,5,0,5,5,15,6,0
396,Chancel Mbemba,COD,DF,Marseille,27,1994,31.7,43,26,24,17,2,22,31,71.0,9,25,12,13,42,85,89,0
397,Jason Mbock,FRA,MF|FW,Angers,22,1999,0.3,0,0,0,0,0,0,0,,0,0,0,0,0,0,0,0
398,Nathanael Mbuku,FRA,FW|MF,Reims,20,2002,0.7,2,1,2,0,0,2,2,100.0,0,0,0,0,0,2,0,0
399,Facundo Medina,ARG,DF,Lens,23,1999,30.9,31,20,16,15,0,13,35,37.1,22,25,9,16,26,57,62,1
400,Bamo Meïté,CIV,DF,Lorient,21,2001,16.7,18,8,13,4,1,7,16,43.8,9,33,23,10,16,34,70,0
401,Farid El Melali,ALG,DF|FW,Angers,25,1997,9.0,21,12,7,12,2,11,22,50.0,11,16,0,16,8,29,7,0
402,Birger Meling,NOR,DF,Rennes,27,1994,13.4,24,15,9,12,3,12,25,48.0,13,18,2,16,23,47,26,0
403,Nuno Mendes,POR,DF,Paris S-G,20,2002,17.2,45,30,29,12,4,30,41,73.2,11,19,3,16,17,62,18,0
404,Pedro Mendes,POR,DF,Montpellier,31,1990,0.1,0,0,0,0,0,0,0,,0,0,0,0,0,0,0,1
405,Thiago Mendes,BRA,MF|DF,Lyon,30,1992,22.9,48,27,24,21,3,30,40,75.0,10,28,8,20,47,95,51,4
406,Antoine Mendy,FRA,DF,Nice,18,2004,5.8,22,13,16,5,1,9,15,60.0,6,6,1,5,2,24,16,0
407,Arial Mendy,SEN,DF,Clermont Foot,27,1994,2.5,4,2,3,0,1,2,2,100.0,0,2,0,2,4,8,4,0
408,Batista Mendy,FRA,MF|DF,Angers,22,2000,31.8,70,30,34,28,8,37,53,69.8,16,38,6,32,21,91,29,2
409,Gideon Mensah,GHA,DF,Auxerre,24,1998,25.1,80,44,43,32,5,44,77,57.1,33,33,10,23,38,118,41,0
410,Quentin Merlin,FRA,DF,Nantes,20,2002,19.9,31,19,19,8,4,18,38,47.4,20,27,4,23,24,55,30,0
411,Lionel Messi,ARG,FW|MF,Paris S-G,35,1987,31.5,26,18,1,13,12,11,27,40.7,16,11,0,11,2,28,0,0
412,Amine Messoussa,FRA,FW,Lille,17,2004,0.0,0,0,0,0,0,0,0,,0,0,0,0,0,0,0,0
413,Arkadiusz Milik,POL,FW,Marseille,28,1994,1.4,1,1,0,0,1,0,1,0.0,1,0,0,0,0,1,2,0
414,Takumi Minamino,JPN,MF|FW,Monaco,27,1995,8.0,15,8,5,7,3,7,35,20.0,28,14,0,14,6,21,4,0
415,Terem Moffi,NGA,FW,Nice,23,1999,14.8,12,6,0,6,6,2,12,16.7,10,3,0,3,2,14,5,0
416,Terem Moffi,NGA,FW,Lorient,23,1999,15.4,8,5,1,4,3,3,5,60.0,2,11,3,8,3,11,10,0
417,Mostafa Mohamed,EGY,FW,Nantes,24,1997,21.5,18,13,5,7,6,9,20,45.0,11,23,1,22,10,28,33,0
418,Florent Mollet,FRA,MF,Nantes,30,1991,12.1,14,6,5,4,5,7,24,29.2,17,12,1,11,10,24,11,0
419,Marlos Moreno,COL,MF|DF,Troyes,25,1996,0.1,2,2,2,0,0,2,3,66.7,1,1,1,0,0,2,0,0
420,Lebo Mothiba,RSA,FW|MF,Strasbourg,26,1996,4.8,1,0,1,0,0,0,1,0.0,1,6,1,5,0,1,4,0
421,Steve Mounié,BEN,FW,Brest,27,1994,18.4,13,5,1,7,5,5,14,35.7,9,18,7,11,3,16,20,0
422,Bevic Moussiti-Oko,CGO,FW,Ajaccio,27,1995,7.8,3,1,1,1,1,1,2,50.0,1,5,3,2,2,5,8,0
423,Samuel Moutoussamy,COD,MF,Nantes,25,1996,26.7,64,34,27,28,9,26,76,34.2,50,23,2,21,24,88,15,0
424,François Mughe,CMR,MF,Marseille,18,2004,0.1,0,0,0,0,0,0,0,,0,0,0,0,0,0,0,0
425,Nordi Mukiele,FRA,DF,Paris S-G,24,1997,12.6,31,23,16,6,9,19,29,65.5,10,22,9,13,14,45,16,0
426,Marshall Munetsi,ZIM,MF,Reims,26,1996,30.0,58,27,13,31,14,20,48,41.7,28,37,11,26,26,84,41,1
427,Yvon Mvogo,SUI,GK,Lorient,28,1994,20.1,0,0,0,0,0,0,0,,0,0,0,0,2,2,6,3
428,Nathan N'Goumou,FRA,FW,Toulouse,22,2000,1.0,3,2,2,1,0,1,1,100.0,0,2,0,2,2,5,0,0
429,Youssouf Ndayishimiye,BDI,MF|DF,Nice,23,1998,6.3,13,9,8,5,0,6,11,54.5,5,8,5,3,12,25,22,1
430,Papa Ndiaga Yade,SEN,DF|MF,Troyes,22,2000,6.3,10,6,6,2,2,7,22,31.8,15,10,2,8,8,18,10,0
431,Neymar,BRA,MF|FW,Paris S-G,30,1992,17.2,22,14,6,9,7,9,19,47.4,10,7,1,6,4,26,1,1
432,Ibrahima Niane,SEN,FW,Angers,23,1999,12.6,6,2,1,4,1,1,6,16.7,5,8,2,6,1,7,9,0
433,M'Baye Niang,SEN,FW,Auxerre,27,1994,16.5,13,7,1,8,4,3,13,23.1,10,22,1,21,1,14,20,0
434,Rasmus Nicolaisen,DEN,DF,Toulouse,25,1997,33.3,48,21,34,14,0,29,46,63.0,17,58,45,13,50,98,152,0
435,Arnaud Nordin,FRA,FW,Montpellier,24,1998,26.7,26,14,10,12,4,12,28,42.9,16,19,1,18,14,40,7,0
436,Riad Nouri,FRA,MF|FW,Ajaccio,37,1985,18.8,21,12,7,10,4,12,29,41.4,17,8,1,7,15,36,11,0
437,Alexander Nübel,GER,GK,Monaco,25,1996,38.0,0,0,0,0,0,0,1,0.0,1,0,0,0,1,1,10,3
438,Gerzino Nyamsi,FRA,DF,Strasbourg,25,1997,17.5,28,20,14,12,2,10,12,83.3,2,19,11,8,10,38,63,1
439,Wilson Odobert,FRA,MF|FW,Troyes,17,2004,19.6,20,14,10,7,3,9,25,36.0,16,11,0,11,15,35,5,0
440,Florent Ogier,FRA,DF,Clermont Foot,33,1989,18.9,33,16,20,12,1,22,39,56.4,17,22,13,9,18,51,64,1
441,Warmed Omari,FRA,DF,Rennes,22,2000,15.1,20,11,14,6,0,14,28,50.0,14,13,7,6,17,37,43,1
442,Jonas Omlin,SUI,GK,Montpellier,28,1994,13.0,1,0,1,0,0,0,0,,0,0,0,0,0,1,8,1
443,Ado Onaiwu,JPN,FW,Toulouse,26,1995,12.0,11,6,4,4,3,5,13,38.5,8,5,1,4,2,13,5,0
444,Jean Onana,CMR,MF|DF,Lens,22,2000,9.0,28,17,8,17,3,10,22,45.5,12,15,5,10,18,46,20,0
445,Loïs Openda,BEL,FW,Lens,22,2000,28.0,11,9,2,6,3,2,13,15.4,11,9,0,9,2,13,6,0
446,Dango Ouattara,BFA,FW|MF,Lorient,20,2002,17.2,41,26,20,11,10,15,28,53.6,13,24,6,18,19,60,21,0
447,Zinédine Ould Khaled,FRA,MF|FW,Angers,22,2000,0.6,1,1,0,1,0,0,1,0.0,1,0,0,0,2,3,0,0
448,Azzedine Ounahi,MAR,MF|FW,Marseille,22,2000,1.3,2,1,1,1,0,0,2,0.0,2,1,0,1,0,2,0,0
449,Azzedine Ounahi,MAR,MF|FW,Angers,22,2000,12.5,19,8,5,13,1,10,20,50.0,10,8,0,8,15,34,4,1
450,Adam Ounas,ALG,FW|MF,Lille,25,1996,11.8,20,11,4,10,6,8,13,61.5,5,16,0,16,7,27,5,0
451,Ante Palaversa,CRO,MF,Troyes,22,2000,0.3,1,1,1,0,0,0,0,,0,0,0,0,1,2,0,0
452,Nicolas Pallois,FRA,DF,Nantes,34,1987,24.6,69,44,51,16,2,42,70,60.0,28,35,18,17,30,99,131,2
453,Erik Palmer-Brown,USA,DF,Troyes,25,1997,35.5,42,27,31,10,1,18,33,54.5,15,56,29,27,26,68,166,1
454,Lucas Paquetá,BRA,MF,Lyon,24,1997,1.8,5,4,0,5,0,1,3,33.3,2,2,0,2,1,6,3,0
455,Leandro Paredes,ARG,MF,Paris S-G,28,1994,0.6,1,1,1,0,0,1,1,100.0,0,2,1,1,1,2,0,0
456,Dimitri Payet,FRA,MF|FW,Marseille,35,1987,9.3,6,4,2,2,2,3,10,30.0,7,4,0,4,0,6,4,0
457,Théo Pellenard,FRA,DF,Auxerre,28,1994,1.1,1,0,1,0,0,1,1,100.0,0,3,1,2,2,3,2,0
458,Timothee Pembele,FRA,DF,Paris S-G,19,2002,2.9,5,5,3,1,1,2,4,50.0,2,2,0,2,4,9,2,0
459,Patrick Pentz,AUT,GK,Reims,25,1997,7.0,0,0,0,0,0,0,0,,0,0,0,0,0,0,1,0
460,Nicolas Pépé,CIV,FW|MF,Nice,27,1995,16.6,25,13,14,5,6,11,25,44.0,14,17,0,17,3,28,1,0
461,Brayann Pereira,FRA,DF,Auxerre,19,2003,2.0,6,5,5,1,0,1,5,20.0,4,2,2,0,2,8,8,1
462,Danilo Pereira,POR,DF|MF,Paris S-G,30,1991,26.8,32,17,15,14,3,19,26,73.1,7,26,19,7,36,68,59,1
463,Mathias Pereira Lage,POR,MF|FW,Brest,25,1996,14.0,20,7,5,14,1,11,29,37.9,18,10,1,9,14,34,12,0
464,Gaëtan Perrin,FRA,MF|FW,Auxerre,26,1996,15.5,17,8,5,6,6,8,30,26.7,22,15,0,15,10,27,9,0
465,Lucas Perrin,FRA,DF,Strasbourg,23,1998,19.6,44,27,28,14,2,25,49,51.0,24,13,5,8,36,80,53,0
466,Ronaël Pierre-Gabriel,FRA,DF,Strasbourg,24,1998,7.3,25,18,11,12,2,15,17,88.2,2,16,3,13,9,34,22,0
467,Julien Ponceau,FRA,MF,Lorient,21,2000,18.4,28,19,10,14,4,10,32,31.3,22,27,3,24,14,42,12,0
468,Łukasz Poręba,POL,MF,Lens,22,2000,2.9,5,4,2,1,2,2,3,66.7,1,3,0,3,4,9,2,0
469,Jackson Porozo,ECU,DF,Troyes,21,2000,18.0,32,20,24,7,1,13,31,41.9,18,24,17,7,33,65,75,0
470,Sanjin Prcić,BIH,MF,Strasbourg,28,1993,18.1,27,12,6,16,5,19,31,61.3,12,22,7,15,25,52,22,0
471,Mehdi Puch Herrantz,FRA,MF,Ajaccio,18,2004,0.5,2,2,0,1,1,1,2,50.0,1,1,0,1,3,5,0,0
472,Ghjuvanni Quilichini,FRA,GK,Ajaccio,19,2002,0.9,0,0,0,0,0,0,0,,0,0,0,0,0,0,1,0
473,Ionuț Radu,ROU,GK,Auxerre,25,1997,17.0,0,0,0,0,0,0,0,,0,0,0,0,0,0,3,3
474,Simon Ramet,FRA,DF,Lille,19,2003,0.0,0,0,0,0,0,0,0,,0,0,0,0,0,0,0,0
475,Adil Rami,FRA,DF,Troyes,36,1985,17.7,19,14,13,5,1,17,32,53.1,15,23,16,7,25,44,75,3
476,Sergio Ramos,ESP,DF,Paris S-G,36,1986,30.0,34,26,14,18,2,23,44,52.3,21,29,13,16,34,68,93,3
477,Aaron Ramsey,WAL,MF,Nice,31,1990,17.6,47,25,18,19,10,16,39,41.0,23,25,4,21,17,64,18,1
478,Lilian Raolisoa,FRA,DF|MF,Angers,22,2000,1.9,11,9,6,3,2,7,10,70.0,3,3,1,2,3,14,5,0
479,Elba Rashani,KVX,MF|FW,Clermont Foot,29,1993,24.0,39,26,13,19,7,13,39,33.3,26,27,2,25,21,60,19,0
480,Rafael Ratão,BRA,FW|MF,Toulouse,26,1995,20.6,52,36,29,16,7,27,73,37.0,46,34,0,34,21,73,7,0
481,Rayan Raveloson,MAD,DF|MF,Auxerre,25,1997,27.0,38,23,21,16,1,23,33,69.7,10,43,12,31,39,77,70,0
482,Jeff Reine-Adélaïde,FRA,MF,Troyes,24,1998,2.6,3,2,2,1,0,1,2,50.0,1,2,0,2,2,5,1,0
483,Jeff Reine-Adélaïde,FRA,MF,Lyon,24,1998,3.7,8,5,1,5,2,5,9,55.6,4,4,0,4,6,14,0,0
484,Alexsandro Ribeiro,BRA,DF,Lille,22,1999,17.9,32,18,24,7,1,19,28,67.9,9,11,2,9,25,57,59,1
485,Rémy Riou,FRA,GK,Lyon,34,1987,6.7,1,0,1,0,0,1,1,100.0,0,0,0,0,0,1,3,0
486,Renaud Ripart,FRA,FW|MF,Troyes,29,1993,14.7,40,23,14,20,6,19,52,36.5,33,29,2,27,7,47,5,0
487,Joe Rodon,WAL,DF,Rennes,24,1997,15.7,11,7,9,2,0,4,10,40.0,6,16,12,4,9,20,54,1
488,Valentin Rongier,FRA,MF,Marseille,27,1994,33.7,93,59,33,47,13,41,77,53.2,36,50,11,39,54,147,38,1
489,Pablo Rosario,NED,MF|DF,Nice,25,1997,19.6,46,26,22,20,4,18,34,52.9,16,15,5,10,23,69,32,1
490,Anthony Rouault,FRA,DF,Toulouse,21,2001,36.8,66,37,54,10,2,30,58,51.7,28,52,26,26,56,122,126,4
491,Kays Ruiz,MAR,MF,Auxerre,19,2002,0.7,1,1,1,0,0,0,1,0.0,1,2,1,1,3,4,0,0
492,Fabián Ruiz Peña,ESP,MF,Paris S-G,26,1996,21.0,62,28,25,30,7,43,79,54.4,36,24,1,23,18,80,23,1
493,Halid Šabanović,BIH,DF,Angers,22,1999,7.1,8,6,7,1,0,6,8,75.0,2,8,2,6,8,16,12,0
494,Falaye Sacko,MLI,DF,Montpellier,27,1995,28.7,46,25,25,15,6,32,51,62.7,19,43,14,29,33,79,75,1
495,Wesley Saïd,FRA,FW|MF,Lens,27,1995,7.2,4,1,1,2,1,2,6,33.3,4,4,0,4,1,5,2,0
496,Théo Sainte-Luce,FRA,DF,Montpellier,23,1998,5.9,13,11,8,5,0,7,14,50.0,7,7,2,5,10,23,11,0
497,Hamza Sakhi,FRA,MF,Auxerre,26,1996,18.4,44,22,22,17,5,22,42,52.4,20,16,1,15,25,69,9,0
498,Mamadou Sakho,FRA,DF,Montpellier,32,1990,8.5,9,5,4,5,0,3,5,60.0,2,17,12,5,8,17,35,1
499,Ibrahim Salah,MAR,FW|MF,Rennes,20,2001,2.5,8,1,5,3,0,2,15,13.3,13,3,0,3,2,10,0,0
500,Amine Salama,FRA,FW|MF,Angers,22,2000,13.9,11,9,3,7,1,2,12,16.7,10,8,2,6,10,21,2,0
501,Yoann Salmier,GUF,DF,Troyes,29,1992,29.4,51,29,34,12,5,21,35,60.0,14,34,19,15,39,90,124,0
502,Mama Samba Baldé,GNB,FW,Troyes,26,1995,29.6,46,21,14,21,11,13,28,46.4,15,30,3,27,10,56,13,0
503,Brice Samba,FRA,GK,Lens,28,1994,37.0,1,0,1,0,0,1,2,50.0,1,1,0,1,0,1,12,2
504,Renato Sanches,POR,MF,Paris S-G,24,1997,8.0,8,1,1,3,4,5,14,35.7,9,13,3,10,9,17,4,0
505,Alexis Sánchez,CHI,FW|MF,Marseille,33,1988,29.8,27,17,5,16,6,3,24,12.5,21,14,0,14,5,32,6,0
506,Morgan Sanson,FRA,MF,Strasbourg,27,1994,15.8,36,25,10,16,10,17,56,30.4,39,21,1,20,22,58,9,0
507,Baptiste Santamaria,FRA,MF,Rennes,27,1995,20.1,41,22,13,23,5,21,41,51.2,20,21,5,16,21,62,23,0
508,Pablo Sarabia,ESP,FW|MF,Paris S-G,30,1992,4.1,5,4,2,2,1,1,7,14.3,6,3,0,3,2,7,0,0
509,Amin Sarr,SWE,FW,Lyon,21,2001,6.0,9,6,1,4,4,1,4,25.0,3,2,0,2,0,9,4,0
510,Malang Sarr,FRA,DF,Monaco,23,1999,8.0,6,3,5,1,0,1,5,20.0,4,11,7,4,15,21,29,2
511,Mamadou Sarr,FRA,MF,Lyon,16,2005,0.1,0,0,0,0,0,0,0,,0,0,0,0,0,0,0,0
512,Téji Savanier,FRA,MF,Montpellier,30,1991,28.3,46,30,16,19,11,23,70,32.9,47,30,2,28,30,76,12,1
513,Kasper Schmeichel,DEN,GK,Nice,35,1986,36.0,1,0,1,0,0,1,4,25.0,3,1,0,1,1,2,11,1
514,Alidu Seidu,GHA,DF,Clermont Foot,22,2000,27.3,52,31,35,14,3,31,51,60.8,20,28,14,14,52,104,50,2
515,Matz Sels,BEL,GK,Strasbourg,30,1992,38.0,4,3,4,0,0,4,4,100.0,0,0,0,0,4,8,23,0
516,Marvin Senaya,TOG,DF,Strasbourg,21,2001,0.1,0,0,0,0,0,0,1,0.0,1,1,0,1,0,0,1,0
517,Kaj Sierhuis,NED,FW|MF,Reims,24,1998,2.4,3,3,1,0,2,0,5,0.0,5,3,1,2,1,4,2,0
518,Vincent Sierro,SUI,MF,Toulouse,26,1995,7.4,19,11,9,9,1,11,29,37.9,18,12,3,9,4,23,11,1
519,Caio Henrique Oliveira Silva,BRA,DF,Monaco,25,1997,32.2,74,51,42,28,4,44,76,57.9,32,28,8,20,26,100,68,1
520,Abdallah Sima,SEN,FW,Angers,21,2001,20.4,22,13,4,15,3,7,19,36.8,12,8,0,8,4,26,19,0
521,Moses Simon,NGA,FW|MF,Nantes,27,1995,26.1,18,9,6,7,5,7,15,46.7,8,14,1,13,11,29,3,0
522,Lassine Sinayoko,MLI,MF|FW,Auxerre,22,1999,17.4,33,15,14,12,7,21,40,52.5,19,12,0,12,18,51,17,0
523,Ibrahima Sissoko,MLI,MF,Strasbourg,24,1997,14.6,40,22,18,17,5,22,42,52.4,20,20,6,14,10,50,19,0
524,Moussa Sissoko,FRA,MF,Nantes,32,1989,21.3,26,16,16,7,3,12,18,66.7,6,22,5,17,16,42,17,0
525,Naatan Skyttä,FIN,MF,Toulouse,20,2002,0.3,0,0,0,0,0,0,0,,0,0,0,0,1,1,0,0
526,Islam Slimani,ALG,FW,Brest,34,1988,11.0,5,3,2,2,1,0,3,0.0,3,2,0,2,1,6,11,0
527,Eduard Sobol,UKR,DF,Strasbourg,27,1995,9.7,19,10,10,6,3,9,13,69.2,4,10,1,9,8,27,19,0
528,Carlos Soler,ESP,MF,Paris S-G,25,1997,13.2,20,12,6,10,4,10,19,52.6,9,12,4,8,4,24,6,0
529,François-Joseph Sollacaro,FRA,GK,Ajaccio,28,1994,6.0,0,0,0,0,0,0,0,,0,0,0,0,0,0,2,2
530,Florian Sotoca,FRA,MF|FW,Lens,31,1990,33.9,39,19,11,17,11,15,40,37.5,25,41,2,39,29,68,51,0
531,Moussa Soumano,FRA,FW,Ajaccio,17,2005,5.5,2,2,0,1,1,0,6,0.0,6,2,0,2,0,2,0,0
532,Arnaud Souquet,FRA,DF|FW,Montpellier,30,1992,4.0,22,16,13,7,2,11,14,78.6,3,8,3,5,4,26,4,0
533,Kevin Spadanuda,SUI,MF|FW,Ajaccio,25,1997,11.8,29,18,15,9,5,12,33,36.4,21,18,0,18,11,40,5,0
534,Djed Spence,ENG,DF,Rennes,21,2000,6.4,14,6,8,2,4,11,18,61.1,7,10,3,7,4,18,15,0
535,Stijn Spierings,NED,MF,Toulouse,26,1996,34.7,95,67,37,49,9,43,101,42.6,58,49,11,38,53,148,44,0
536,Calvin Stengs,NED,FW,Nice,23,1998,2.4,2,2,1,0,1,1,2,50.0,1,0,0,0,0,2,0,0
537,Tony Strata,FRA,MF|DF,Ajaccio,17,2004,1.5,4,3,4,0,0,4,5,80.0,1,2,0,2,1,5,7,0
538,Gabriel Suazo,CHI,DF,Toulouse,24,1997,14.0,38,22,20,15,3,29,63,46.0,34,21,5,16,22,60,24,1
539,Kamaldeen Sulemana,GHA,FW|MF,Rennes,20,2002,3.6,6,3,1,4,1,1,5,20.0,4,2,0,2,4,10,2,0
540,Yuito Suzuki,JPN,FW|MF,Strasbourg,20,2001,0.4,0,0,0,0,0,0,0,,0,3,0,3,0,0,0,0
541,Issiaga Sylla,GUI,DF,Montpellier,28,1994,14.5,28,16,19,8,1,15,31,48.4,16,19,3,16,32,60,35,0
542,Issiaga Sylla,GUI,DF,Toulouse,28,1994,15.2,28,15,14,9,5,15,34,44.1,19,15,5,10,38,66,38,0
543,Nicolás Tagliafico,ARG,DF,Lyon,29,1992,33.2,91,53,36,41,14,50,78,64.1,28,45,11,34,57,148,47,0
544,Waniss Taibi,FRA,MF,Angers,20,2002,2.1,9,5,4,4,1,2,4,50.0,2,1,0,1,2,11,2,0
545,Flavien Tait,FRA,MF,Rennes,29,1993,18.7,30,15,8,17,5,19,42,45.2,23,16,4,12,20,50,12,0
546,Montassar Talbi,TUN,DF,Lorient,24,1998,38.0,53,25,40,13,0,22,35,62.9,13,55,34,21,40,93,190,3
547,Thibault Tamas,FRA,DF,Montpellier,21,2001,0.1,0,0,0,0,0,0,0,,0,0,0,0,1,1,0,0
548,Florian Tardieu,FRA,MF,Troyes,30,1992,11.2,31,20,19,12,0,12,31,38.7,19,19,4,15,23,54,15,0
549,Nuno Tavares,POR,DF|MF,Marseille,22,2000,26.1,56,30,19,24,13,28,55,50.9,27,32,4,28,15,71,25,0
550,Enzo Tchato,CMR,DF,Montpellier,19,2002,12.2,26,17,14,11,1,13,22,59.1,9,17,2,15,7,33,33,0
551,Martin Terrier,FRA,FW|MF,Rennes,25,1997,14.7,25,11,7,9,9,13,24,54.2,11,15,2,13,14,39,6,0
552,Tetê,BRA,FW|MF,Lyon,22,2000,12.3,21,10,8,5,8,10,19,52.6,9,9,0,9,13,34,2,0
553,Arthur Theate,BEL,DF,Rennes,22,2000,34.7,29,19,17,8,4,17,30,56.7,13,26,14,12,30,59,114,3
554,Sada Thioub,SEN,DF|FW,Angers,27,1995,11.8,19,10,9,8,2,8,17,47.1,9,13,0,13,7,26,5,1
555,Adrien Thomasson,FRA,MF,Strasbourg,28,1993,10.4,19,9,8,6,5,9,30,30.0,21,18,0,18,3,22,2,0
556,Adrien Thomasson,FRA,MF|FW,Lens,28,1993,14.2,24,17,8,11,5,12,45,26.7,33,25,2,23,4,28,17,0
557,Khéphren Thuram,FRA,MF,Nice,21,2001,28.3,51,25,22,23,6,19,43,44.2,24,33,13,20,38,89,34,0
558,Alexis Tibidi,FRA,FW|MF,Troyes,18,2003,0.8,1,1,1,0,0,0,0,,0,0,0,0,0,1,0,0
559,Jean-Clair Todibo,FRA,DF,Nice,22,1999,31.9,76,48,54,19,3,41,56,73.2,15,41,19,22,41,117,110,2
560,Karl Toko Ekambi,CMR,FW|MF,Rennes,29,1992,10.8,3,1,1,1,1,3,9,33.3,6,5,0,5,9,12,3,0
561,Karl Toko Ekambi,CMR,FW|MF,Lyon,29,1992,15.0,9,9,2,4,3,4,15,26.7,11,12,2,10,9,18,6,0
562,Corentin Tolisso,FRA,MF,Lyon,27,1994,22.6,44,27,16,23,5,25,66,37.9,41,25,5,20,24,68,23,1
563,Birama Touré,MLI,MF,Auxerre,30,1992,37.8,80,47,35,35,10,34,93,36.6,59,54,9,45,67,147,49,0
564,Mohamed Toure,AUS,FW|MF,Reims,18,2004,0.3,0,0,0,0,0,0,0,,0,0,0,0,0,0,0,0
565,Souleymane Touré,FRA,DF,Marseille,19,2003,0.8,2,1,1,1,0,1,2,50.0,1,1,0,1,0,2,5,0
566,Souleymane Touré,FRA,DF,Auxerre,19,2003,17.6,29,13,19,9,1,16,20,80.0,4,32,12,20,26,55,56,1
567,Yoann Touzghar,TUN,FW,Ajaccio,35,1986,5.0,3,2,0,2,1,0,1,0.0,1,0,0,0,0,3,1,0
568,Charles Traore,MLI,DF,Nantes,30,1992,5.4,8,5,5,2,1,5,7,71.4,2,9,2,7,10,18,12,0
569,Hamari Traoré,MLI,DF,Rennes,30,1992,28.1,48,32,26,15,7,28,52,53.8,24,33,7,26,38,86,64,0
570,Théo Trinker,FRA,MF,Nice,21,2001,0.0,0,0,0,0,0,0,0,,0,0,0,0,0,0,0,0
571,Adrien Truffert,FRA,DF,Rennes,20,2001,21.7,62,32,36,17,9,31,46,67.4,15,32,8,24,22,84,55,0
572,Theocharis Tsingaras,GRE,MF,Toulouse,21,2000,0.1,0,0,0,0,0,0,0,,0,0,0,0,0,0,0,0
573,Ike Ugbo,CAN,FW|MF,Troyes,23,1998,9.9,5,2,2,2,1,3,11,27.3,8,8,2,6,2,7,4,0
574,Lesley Ugochukwu,FRA,MF,Rennes,18,2004,14.8,36,19,13,20,3,16,24,66.7,8,24,10,14,21,57,16,0
575,Cengiz Ünder,TUR,MF|DF,Marseille,25,1997,27.7,37,19,15,13,9,13,34,38.2,21,18,2,16,18,55,13,0
576,Jere Uronen,FIN,DF,Brest,28,1994,3.3,8,5,4,4,0,7,12,58.3,5,6,2,4,7,15,5,0
577,Yan Valery,TUN,DF,Angers,23,1999,27.7,54,39,28,20,6,20,37,54.1,17,35,15,20,34,88,82,0
578,Vanderson,BRA,DF|MF,Monaco,21,2001,24.6,84,48,36,34,14,44,75,58.7,31,36,9,27,48,132,36,1
579,Jordan Veretout,FRA,MF,Marseille,29,1993,31.8,56,35,17,32,7,25,53,47.2,28,22,7,15,36,92,40,2
580,Marco Verratti,ITA,MF,Paris S-G,29,1992,24.4,76,49,34,36,6,38,89,42.7,51,42,6,36,27,103,11,3
581,João Victor,BRA,DF,Nantes,24,1998,9.4,19,11,9,7,3,12,22,54.5,10,11,1,10,15,34,30,0
582,Clément Vidal,FRA,DF|MF,Ajaccio,22,2000,21.1,25,15,14,11,0,18,38,47.4,20,27,16,11,27,52,73,1
583,Alan Virginius,FRA,FW,Lille,19,2003,2.9,3,2,1,1,1,0,4,0.0,4,0,0,0,2,5,1,0
584,Mattia Viti,ITA,DF,Nice,20,2002,7.0,4,2,1,1,2,2,5,40.0,3,9,3,6,8,12,22,0
585,Vitinha,POR,FW,Marseille,22,2000,5.2,15,7,0,6,9,3,11,27.3,8,3,0,3,2,17,6,0
586,Vitinha,POR,MF,Paris S-G,22,2000,27.2,58,25,21,27,10,27,83,32.5,56,27,4,23,25,83,15,0
587,Kevin Volland,GER,FW|MF,Monaco,30,1992,7.1,8,4,1,5,2,2,8,25.0,6,8,0,8,2,10,0,0
588,Elye Wahi,FRA,FW,Montpellier,19,2003,27.9,9,3,2,3,4,5,14,35.7,9,14,2,12,3,12,5,0
589,Timothy Weah,USA,DF|FW,Lille,22,2000,19.4,24,14,13,9,2,16,29,55.2,13,17,3,14,23,47,18,0
590,Mateusz Wieteska,POL,DF,Clermont Foot,25,1997,34.6,41,23,28,13,0,19,33,57.6,14,44,28,16,56,97,97,4
591,Christopher Wooh,CMR,DF,Rennes,20,2001,11.2,16,7,8,8,0,9,11,81.8,2,11,5,6,6,22,49,0
592,Christopher Wooh,CMR,MF,Lens,20,2001,0.0,0,0,0,0,0,0,1,0.0,1,0,0,0,0,0,1,0
593,Xeka,POR,MF,Rennes,27,1994,6.1,10,3,6,3,1,7,16,43.8,9,11,2,9,6,16,8,0
594,Yusuf Yazıcı,TUR,MF,Lille,25,1997,2.2,0,0,0,0,0,0,0,,0,2,0,2,0,0,1,0
595,Darlin Yongwa,CMR,DF,Lorient,21,2000,8.7,13,11,7,5,1,4,15,26.7,11,13,1,12,5,18,11,0
596,Leny Yoro,FRA,DF,Lille,16,2005,8.5,11,5,8,3,0,4,9,44.4,5,6,1,5,18,29,27,1
597,Mohamed Youssouf,COM,DF,Ajaccio,34,1988,27.3,72,44,41,24,7,38,61,62.3,23,32,8,24,65,137,70,0
598,Warren Zaire-Emery,FRA,MF|DF,Paris S-G,16,2006,10.3,17,10,5,10,2,8,29,27.6,21,11,0,11,12,29,17,0
599,Oliver Zandén,SWE,DF|MF,Toulouse,20,2001,1.6,2,1,1,0,1,2,5,40.0,3,0,0,0,1,3,7,0
600,Akim Zedadka,ALG,DF,Auxerre,27,1995,17.8,35,21,21,10,4,18,32,56.3,14,17,3,14,23,58,51,1
601,Akim Zedadka,ALG,DF|MF,Lille,27,1995,3.9,1,1,1,0,0,0,2,0.0,2,3,0,3,2,3,6,0
602,Mehdi Zeffane,ALG,DF|MF,Clermont Foot,30,1992,7.3,12,7,5,7,0,4,21,19.0,17,14,6,8,22,34,12,0
603,Arber Zeneli,KVX,FW|MF,Reims,27,1995,11.1,9,3,3,3,3,5,12,41.7,7,8,0,8,2,11,2,0
604,Nathan Zeze,FRA,DF,Nantes,17,2005,0.7,3,2,2,1,0,1,1,100.0,0,0,0,0,0,3,1,0
605,Edon Zhegrova,KVX,FW|MF,Lille,23,1999,11.7,18,12,6,7,5,12,20,60.0,8,9,0,9,2,20,2,0
606,Tanguy Zoukrou,FRA,DF,Troyes,19,2003,5.7,14,7,8,6,0,10,14,71.4,4,18,11,7,2,16,24,0
