Rk,Player,Nation,Pos,Squad,Age,Born,90s,Tackles Tkl,Tackles TklW,Tackles Def 3rd,Tackles Mid 3rd,Tackles Att 3rd,Challenges Tkl,Challenges Att,Challenges Tkl%,Challenges Lost,Blocks Blocks,Blocks Sh,Blocks Pass,Int,Tkl+Int,Clr,Err
1,Antonio Adán,ESP,GK,Atlético Madrid,32,1987,0.3,0,0,0,0,0,0,0,,0,0,0,0,0,0,0,0
2,Aritz Aduriz,ESP,FW|MF,Athletic Club,38,1981,2.3,3,2,0,3,0,0,0,,0,0,0,0,0,3,2,0
3,Lumor Agbenyenu,GHA,DF,Mallorca,22,1996,20.1,31,21,19,9,3,16,35,45.7,19,13,2,11,21,52,66,1
4,Martin Agirregabiria,ESP,DF,Alavés,23,1996,23.3,55,30,32,18,5,30,54,55.6,24,19,7,12,18,73,48,0
5,Joseph Aidoo,GHA,DF,Celta Vigo,23,1995,27.8,43,27,30,11,2,13,27,48.1,14,31,14,17,45,88,124,3
6,Jordi Alba,ESP,DF,Barcelona,30,1989,24.3,20,13,9,7,4,6,27,22.2,21,12,3,9,37,57,40,0
7,Raúl Albiol,ESP,DF,Villarreal,33,1985,36.0,43,23,27,16,0,18,27,66.7,9,29,21,8,42,85,175,2
8,Paco Alcácer,ESP,FW,Villarreal,25,1993,10.3,3,3,2,1,0,1,7,14.3,6,4,1,3,2,5,10,0
9,Rubén Alcaraz,ESP,MF,Valladolid,28,1991,21.4,61,30,37,20,4,30,63,47.6,33,46,15,31,15,76,41,0
10,Álex Alegría,ESP,FW,Mallorca,26,1992,1.2,1,0,1,0,0,0,0,,0,2,0,2,0,1,0,0
11,Carles Aleñá,ESP,MF,Barcelona,21,1998,1.9,2,1,1,1,0,1,4,25.0,3,1,0,1,0,2,0,0
12,Carles Aleñá,ESP,MF|FW,Betis,21,1998,8.2,14,9,5,7,2,3,17,17.6,14,4,1,3,1,15,3,0
13,Sergio Álvarez,ESP,MF|DF,Eibar,27,1992,12.7,37,22,11,24,2,8,24,33.3,16,16,2,14,17,54,26,1
14,Sergio Álvarez,ESP,GK,Celta Vigo,32,1986,2.0,0,0,0,0,0,0,0,,0,0,0,0,0,0,1,0
15,Yeray Álvarez,ESP,DF,Athletic Club,24,1995,31.2,36,19,28,7,1,17,30,56.7,13,33,22,11,62,98,138,2
16,Ibrahim Amadou,FRA,MF,Leganés,26,1993,8.6,16,9,5,9,2,4,11,36.4,7,5,0,5,12,28,6,0
17,Amath,SEN,MF,Getafe,23,1996,0.7,2,1,1,1,0,0,5,0.0,5,2,0,2,0,2,0,0
18,Miguel Ángel Guerrero,ESP,FW,Leganés,29,1990,8.8,1,0,0,1,0,1,10,10.0,9,4,0,4,2,3,4,0
19,José Ángel,ESP,DF,Eibar,29,1989,26.2,54,31,26,25,3,26,43,60.5,17,23,7,16,33,87,61,1
20,Miguel Ángel Moyá,ESP,GK,Real Sociedad,35,1984,13.0,0,0,0,0,0,0,1,0.0,1,0,0,0,1,1,6,2
21,Antoñito,ESP,DF|MF,Valladolid,31,1987,11.4,26,18,19,7,0,12,20,60.0,8,9,0,9,15,41,20,1
22,Vitorino Antunes,POR,MF,Getafe,32,1987,0.1,0,0,0,0,0,0,0,,0,0,0,0,0,0,1,0
23,Anuar,MAR,MF|FW,Valladolid,24,1995,2.1,4,2,1,2,1,2,6,33.3,4,7,3,4,5,9,0,0
24,Mauro Arambarri,URU,MF,Getafe,23,1995,34.1,72,33,24,40,8,31,69,44.9,38,52,5,47,43,115,40,2
25,Néstor Araujo,MEX,DF,Celta Vigo,27,1991,32.1,44,27,35,8,1,22,36,61.1,14,26,18,8,52,96,142,0
26,Ronald Araújo,URU,DF,Barcelona,20,1999,2.6,3,2,2,1,0,1,1,100.0,0,6,2,4,0,3,9,0
27,Anaitz Arbilla,ESP,DF,Eibar,32,1987,22.3,33,20,23,8,2,16,34,47.1,18,20,4,16,29,62,82,0
28,Alphonse Areola,FRA,GK,Real Madrid,26,1993,4.0,0,0,0,0,0,0,0,,0,0,0,0,0,0,0,0
29,Santiago Arias,COL,DF,Atlético Madrid,27,1992,12.0,36,24,20,12,4,10,18,55.6,8,12,7,5,19,55,20,1
30,José Arnaiz,ESP,FW|MF,Osasuna,24,1995,8.8,3,2,0,2,1,0,12,0.0,12,7,0,7,5,8,5,0
31,José Arnaiz,ESP,MF,Leganés,24,1995,3.7,3,0,1,2,0,2,5,40.0,3,4,0,4,2,5,1,0
32,Sergio Asenjo,ESP,GK,Villarreal,30,1989,34.0,0,0,0,0,0,0,2,0.0,2,0,0,0,1,1,15,1
33,Marco Asensio,ESP,FW,Real Madrid,23,1996,3.7,4,3,3,1,0,1,4,25.0,3,2,0,2,1,5,4,0
34,Iago Aspas,ESP,FW,Celta Vigo,31,1987,36.2,29,19,7,9,13,12,45,26.7,33,16,1,15,22,51,7,0
35,Roger Assalé,CIV,FW|MF,Leganés,25,1993,5.9,3,2,1,0,2,1,9,11.1,8,8,0,8,0,3,1,0
36,Miguel Atienza,ESP,MF,Eibar,20,1999,0.3,1,1,0,1,0,1,2,50.0,1,1,1,0,2,3,1,0
37,Ezequiel Ávila,ARG,FW,Osasuna,25,1994,17.7,17,12,6,7,4,6,18,33.3,12,12,0,12,3,20,5,0
38,Javier Avilés,ESP,MF|FW,Leganés,21,1997,2.0,9,7,2,7,0,2,4,50.0,2,3,0,3,3,12,1,0
39,Chidozie Awaziem,NGA,DF,Leganés,22,1997,22.2,34,22,29,5,0,16,27,59.3,11,26,15,11,28,62,73,1
40,Ramon Azeez,NGA,MF,Granada,26,1992,15.1,11,8,2,8,1,7,19,36.8,12,8,2,6,19,30,11,1
41,Iddrisu Baba,GHA,MF,Mallorca,23,1996,32.3,59,37,26,29,4,20,70,28.6,50,31,8,23,39,98,42,0
42,Carlos Bacca,COL,FW,Villarreal,32,1986,7.6,5,1,1,2,2,2,6,33.3,4,4,0,4,0,5,7,0
43,Alex Baena,ESP,MF,Villarreal,18,2001,0.2,0,0,0,0,0,0,0,,0,1,0,1,0,0,0,0
44,Gareth Bale,WAL,FW|MF,Real Madrid,30,1989,12.1,9,5,5,2,2,3,14,21.4,11,8,2,6,6,15,9,0
45,Mikel Balenziaga,ESP,DF,Athletic Club,31,1988,6.3,15,10,4,10,1,9,11,81.8,2,4,1,3,2,17,20,0
46,Éver Banega,ARG,MF,Sevilla,31,1988,27.5,43,28,16,18,9,21,70,30.0,49,19,1,18,15,58,5,0
47,Federico Barba,ITA,DF,Valladolid,25,1993,5.0,12,6,10,2,0,7,9,77.8,2,5,2,3,8,20,12,0
48,Enis Bardhi,MKD,MF,Levante,24,1995,23.5,24,11,7,15,2,8,35,22.9,27,15,4,11,15,39,19,0
49,Kike Barja,ESP,MF|FW,Osasuna,22,1997,3.5,1,1,1,0,0,1,1,100.0,0,3,1,2,0,1,2,0
50,Antonio Barragán,ESP,DF,Betis,32,1987,7.1,7,5,4,2,1,3,6,50.0,3,2,2,0,8,15,22,0
51,Ander Barrenetxea,ESP,FW|MF,Real Sociedad,17,2001,4.9,12,9,5,5,2,4,10,40.0,6,3,0,3,3,15,4,0
52,Marc Bartra,ESP,DF|MF,Betis,28,1991,28.0,62,34,39,23,0,27,54,50.0,27,45,24,21,35,97,127,0
53,Gil Bastião Dias,POR,MF|DF,Granada,22,1996,4.0,19,14,10,6,3,7,17,41.2,10,4,1,3,3,22,7,0
54,Fran Beltrán,ESP,MF,Celta Vigo,20,1999,20.3,31,19,15,12,4,11,35,31.4,24,14,1,13,14,45,17,0
55,Hatem Ben Arfa,FRA,MF|FW,Valladolid,32,1987,1.8,0,0,0,0,0,0,4,0.0,4,1,0,1,0,0,0,0
56,Karim Benzema,FRA,FW,Real Madrid,31,1987,34.9,18,8,3,11,4,2,16,12.5,14,16,4,12,7,25,30,1
57,Yuri Berchiche,ESP,DF,Athletic Club,29,1990,31.7,48,35,32,15,1,21,40,52.5,19,26,4,22,30,78,73,1
58,Markel Bergara,ESP,MF,Getafe,33,1986,0.8,0,0,0,0,0,0,0,,0,0,0,0,0,0,2,0
59,Sergio Bermejo,ESP,MF|FW,Celta Vigo,21,1997,0.1,0,0,0,0,0,0,0,,0,0,0,0,0,0,0,0
60,Pedro Bigas,ESP,DF,Eibar,28,1990,19.7,18,9,11,7,0,9,19,47.4,10,16,10,6,36,54,82,0
61,Rubén Blanco,ESP,GK,Celta Vigo,24,1995,32.9,1,1,1,0,0,1,1,100.0,0,0,0,0,0,1,14,1
62,Pablo de Blasis,ARG,DF|MF,Eibar,31,1988,17.8,41,32,22,13,6,30,63,47.6,33,13,0,13,24,65,21,0
63,Alejandro Blesa,ESP,MF,Levante,17,2002,0.0,0,0,0,0,0,0,1,0.0,1,0,0,0,0,0,0,0
64,Yassine Bounou,MAR,GK,Sevilla,28,1991,5.5,0,0,0,0,0,0,0,,0,0,0,0,0,0,0,0
65,Filip Bradarić,CRO,MF,Celta Vigo,27,1992,7.8,12,9,5,5,2,3,8,37.5,5,12,3,9,17,29,19,0
66,Martin Braithwaite,DEN,FW|MF,Barcelona,28,1991,4.5,2,2,2,0,0,0,8,0.0,8,3,0,3,1,3,1,0
67,Martin Braithwaite,DEN,FW|MF,Leganés,28,1991,21.5,13,7,4,5,4,4,12,33.3,8,10,2,8,4,17,9,0
68,Brandon,ESP,FW,Osasuna,24,1995,4.5,5,3,1,3,1,0,5,0.0,5,4,0,4,0,5,1,0
69,Darko Brašanac,SRB,MF,Osasuna,27,1992,24.9,45,25,14,26,5,15,41,36.6,26,19,4,15,20,65,21,0
70,Yan Brice Eteki,CMR,MF,Granada,21,1997,16.7,37,21,14,18,5,15,31,48.4,16,17,4,13,24,61,20,1
71,Ante Budimir,CRO,FW,Mallorca,28,1991,30.7,31,15,4,22,5,7,29,24.1,22,21,4,17,8,39,29,0
72,Esteban Burgos,ARG,DF,Eibar,27,1992,12.4,11,9,9,2,0,5,9,55.6,4,11,6,5,17,28,66,2
73,Burgui,ESP,MF,Alavés,25,1993,0.2,0,0,0,0,0,0,0,,0,0,0,0,0,0,0,0
74,Oliver Burke,SCO,MF|FW,Alavés,22,1997,15.9,19,14,8,9,2,10,23,43.5,13,24,0,24,8,27,16,0
75,Sergio Busquets,ESP,MF,Barcelona,31,1988,27.6,80,44,23,43,14,41,71,57.7,30,36,5,31,44,124,24,2
76,Unai Bustinza,ESP,DF,Leganés,27,1992,29.8,66,40,40,19,7,32,53,60.4,21,30,9,21,65,131,77,0
77,Erick Cabaco,URU,DF,Getafe,24,1995,3.0,3,2,1,2,0,0,3,0.0,3,1,1,0,3,6,11,0
78,Erick Cabaco,URU,DF,Levante,24,1995,9.0,12,9,9,3,0,4,6,66.7,2,12,7,5,12,24,50,1
79,Ariday Cabrera,ESP,MF,Mallorca,30,1988,0.4,1,1,1,0,0,0,1,0.0,1,2,0,2,0,1,0,0
80,Leandro Cabrera,URU,DF,Getafe,28,1991,17.0,10,6,5,5,0,5,12,41.7,7,10,4,6,21,31,66,0
81,Leandro Cabrera,URU,DF,Espanyol,28,1991,17.0,27,11,17,9,1,17,28,60.7,11,19,12,7,21,48,78,1
82,Fernando Calero,ESP,DF,Espanyol,23,1995,11.6,14,9,10,4,0,7,15,46.7,8,13,5,8,8,22,42,1
83,Jonathan Calleri,ARG,FW,Espanyol,25,1993,20.1,12,8,6,4,2,3,24,12.5,21,11,3,8,7,19,22,0
84,Víctor Camarasa,ESP,MF,Alavés,25,1994,14.4,18,10,5,10,3,7,18,38.9,11,8,3,5,15,33,12,0
85,Sergio Camello,ESP,FW,Atlético Madrid,18,2001,0.3,0,0,0,0,0,0,0,,0,0,0,0,0,0,0,0
86,José Campaña,ESP,MF,Levante,26,1993,35.1,38,25,15,13,10,13,53,24.5,40,30,5,25,44,82,42,2
87,Xisco Campos,ESP,DF,Mallorca,37,1982,5.3,7,4,5,2,0,5,9,55.6,4,8,5,3,11,18,23,0
88,Víctor Campuzano,ESP,FW,Espanyol,22,1997,9.7,12,9,1,6,5,3,19,15.8,16,8,0,8,2,14,4,0
89,Sergio Canales,ESP,MF|FW,Betis,28,1991,35.1,25,16,14,6,5,7,28,25.0,21,30,1,29,13,38,16,0
90,Ander Capa,ESP,DF,Athletic Club,27,1992,31.9,64,36,37,21,6,24,59,40.7,35,26,7,19,28,92,63,0
91,Marc Cardona,ESP,FW,Osasuna,24,1995,7.8,1,0,0,1,0,0,8,0.0,8,3,1,2,2,3,2,0
92,Diego Carlos,BRA,DF,Sevilla,26,1993,34.8,35,23,25,9,1,15,25,60.0,10,33,24,9,37,72,176,1
93,Yannick Carrasco,BEL,MF|FW,Atlético Madrid,25,1993,7.0,11,7,4,4,3,7,21,33.3,14,9,0,9,5,16,2,0
94,Daniel Carriço,POR,DF,Sevilla,30,1988,9.4,8,2,4,3,1,1,6,16.7,5,4,3,1,8,16,23,0
95,Guido Carrillo,ARG,FW,Leganés,28,1991,13.5,13,10,3,6,4,2,14,14.3,12,9,1,8,3,16,22,0
96,Dani Carvajal,ESP,DF,Real Madrid,27,1992,30.4,65,46,33,25,7,23,42,54.8,19,43,14,29,36,101,53,0
97,William Carvalho,POR,MF,Betis,27,1992,9.9,7,4,4,2,1,4,14,28.6,10,7,5,2,4,11,8,1
98,Casemiro,BRA,MF,Real Madrid,27,1992,34.3,96,60,43,45,8,39,99,39.4,60,53,10,43,68,164,72,0
99,Santi Cazorla,ESP,MF,Villarreal,34,1984,27.2,48,25,14,21,13,20,57,35.1,37,23,1,22,19,67,16,2
100,Sofian Chakla,MAR,DF,Villarreal,25,1993,2.0,0,0,0,0,0,0,1,0.0,1,2,1,1,3,3,7,1
101,Charles,BRA,FW,Eibar,35,1984,14.5,10,5,0,6,4,4,22,18.2,18,7,2,5,7,17,6,0
102,Pablo Chavarría,ARG,FW|MF,Mallorca,31,1988,2.3,1,1,0,1,0,0,4,0.0,4,1,1,0,1,2,2,0
103,Pape Cheikh Diop,SEN,MF,Celta Vigo,21,1997,6.7,10,4,6,3,1,2,12,16.7,10,4,2,2,5,15,3,0
104,Chema,ESP,DF,Getafe,27,1992,3.4,4,3,1,3,0,1,2,50.0,1,1,0,1,5,9,12,0
105,Denis Cheryshev,RUS,MF|FW,Valencia,28,1990,10.3,16,9,5,4,7,3,17,17.6,14,15,1,14,7,23,10,0
106,Samuel Chukwueze,NGA,FW|MF,Villarreal,20,1999,22.8,23,14,12,6,5,13,30,43.3,17,15,1,14,10,33,14,1
107,Churripi,ESP,GK,Valladolid,25,1994,2.7,1,1,1,0,0,1,1,100.0,0,0,0,0,0,1,2,0
108,Jasper Cillessen,NED,GK,Valencia,30,1989,23.3,0,0,0,0,0,0,1,0.0,1,0,0,0,3,3,3,1
109,Óscar Clemente,ESP,MF,Atlético Madrid,20,1999,0.0,0,0,0,0,0,0,0,,0,1,0,1,0,0,0,0
110,Carlos Clerc,ESP,DF,Levante,27,1992,20.5,28,16,14,13,1,12,20,60.0,8,22,9,13,22,50,61,0
111,Coke,ESP,DF,Levante,32,1987,11.0,25,18,14,8,3,14,30,46.7,16,9,2,7,13,38,19,0
112,Álex Collado,ESP,FW,Barcelona,20,1999,0.1,0,0,0,0,0,0,0,,0,0,0,0,0,0,0,0
113,Francis Coquelin,FRA,MF,Valencia,28,1991,21.2,37,21,25,11,1,16,38,42.1,22,19,9,10,38,75,25,0
114,Sébastien Corchia,FRA,DF,Espanyol,28,1990,3.0,2,1,2,0,0,2,4,50.0,2,5,2,3,5,7,8,0
115,Iñigo Córdoba,ESP,FW,Athletic Club,22,1997,16.0,33,20,16,12,5,14,52,26.9,38,30,2,28,16,49,13,0
116,Ángel Correa,ARG,MF|FW,Atlético Madrid,24,1995,22.9,25,9,7,9,9,9,36,25.0,27,23,5,18,14,39,21,0
117,Rober Correa,ESP,DF,Eibar,26,1992,10.3,13,6,8,3,2,6,10,60.0,4,6,4,2,16,29,31,0
118,Thierry Correia,POR,DF,Valencia,20,1999,2.9,8,3,5,3,0,1,2,50.0,1,5,0,5,2,10,10,0
119,Antonio Cortés,ESP,FW|MF,Granada,19,2000,2.0,1,1,0,1,0,0,1,0.0,1,0,0,0,0,1,2,0
120,Diego Costa,ESP,FW,Atlético Madrid,30,1988,15.0,9,5,1,4,4,1,10,10.0,9,4,2,2,3,12,10,0
121,Jaume Costa,ESP,DF,Valencia,31,1988,15.4,27,23,17,8,2,14,28,50.0,14,11,6,5,24,51,52,1
122,David Costas,ESP,DF,Celta Vigo,24,1995,3.8,4,3,3,1,0,2,4,50.0,2,3,3,0,8,12,12,0
123,Thibaut Courtois,BEL,GK,Real Madrid,27,1992,34.0,0,0,0,0,0,0,2,0.0,2,0,0,0,2,2,18,2
124,Sebastián Cristóforo,URU,MF,Eibar,25,1993,9.7,35,19,11,14,10,13,32,40.6,19,25,3,22,8,43,2,0
125,Cucho,COL,FW|MF,Mallorca,20,1999,16.5,15,8,6,8,1,6,21,28.6,15,14,1,13,10,25,15,0
126,Marc Cucurella,ESP,MF|DF,Getafe,21,1998,36.0,74,51,23,38,13,24,76,31.6,52,58,8,50,36,110,28,1
127,Iván Cuéllar,ESP,GK,Leganés,35,1984,27.0,0,0,0,0,0,0,2,0.0,2,0,0,0,0,0,28,2
128,Moanes Dabbur,ISR,FW,Sevilla,27,1992,0.3,1,1,0,0,1,0,0,,0,1,0,1,0,1,0,0
129,Sergi Darder,ESP,MF,Espanyol,25,1993,29.5,47,23,11,26,10,17,58,29.3,41,30,1,29,24,71,23,1
130,Ousmane Dembélé,FRA,FW,Barcelona,22,1997,4.0,2,2,1,1,0,2,5,40.0,3,4,0,4,0,2,0,1
131,Deyverson,BRA,FW,Getafe,28,1991,2.3,0,0,0,0,0,0,1,0.0,1,2,1,1,0,0,5,0
132,Mouctar Diakhaby,GUI,DF,Valencia,22,1996,16.0,11,8,7,3,1,5,8,62.5,3,17,15,2,11,22,73,0
133,Brahim Díaz,ESP,FW,Real Madrid,19,1999,0.7,1,0,0,1,0,0,2,0.0,2,2,0,2,0,1,0,0
134,Víctor Díaz,ESP,DF,Granada,31,1988,32.0,74,43,38,31,5,31,60,51.7,29,53,23,30,48,122,94,1
135,Papakouli Diop,SEN,MF,Eibar,33,1986,25.0,39,26,13,22,4,18,42,42.9,24,24,7,17,34,73,38,0
136,Djené,TOG,DF,Getafe,27,1991,34.0,42,32,27,15,0,17,30,56.7,13,20,7,13,34,76,105,1
137,Naïs Djouahra,FRA,FW,Real Sociedad,19,1999,0.3,0,0,0,0,0,0,0,,0,0,0,0,0,0,0,0
138,Marko Dmitrović,SRB,GK,Eibar,27,1992,35.0,3,2,3,0,0,3,5,60.0,2,1,0,1,3,6,24,0
139,Jaume Doménech,ESP,GK,Valencia,28,1990,14.7,0,0,0,0,0,0,1,0.0,1,0,0,0,1,1,3,1
140,Domingos Duarte,POR,DF,Granada,24,1995,34.3,30,19,24,5,1,11,20,55.0,9,34,24,10,34,64,153,1
141,Óscar Duarte,CRC,DF,Levante,30,1989,5.4,12,3,11,1,0,3,4,75.0,1,7,6,1,6,18,29,0
142,Rubén Duarte,ESP,DF,Alavés,23,1995,29.6,61,32,30,28,3,34,60,56.7,26,30,8,22,47,108,71,0
143,Hugo Duro,ESP,FW|MF,Getafe,19,1999,4.2,6,5,2,2,2,4,8,50.0,4,3,0,3,1,7,3,0
144,Aritz Elustondo,ESP,DF,Real Sociedad,25,1994,16.8,28,17,19,8,1,13,23,56.5,10,21,8,13,15,43,67,0
145,Rodrigo Ely,BRA,DF,Alavés,25,1993,23.6,22,13,15,7,0,13,29,44.8,16,23,19,4,32,54,116,0
146,Adri Embarba,ESP,MF|FW,Espanyol,27,1992,15.2,37,22,16,16,5,16,33,48.5,17,28,4,24,16,53,11,0
147,Emerson,BRA,DF,Betis,20,1999,31.5,74,46,49,19,6,36,79,45.6,43,30,9,21,31,105,57,1
148,Youssef En-Nesyri,MAR,FW,Leganés,22,1997,15.4,9,7,1,2,6,3,17,17.6,14,15,2,13,5,14,22,0
149,Youssef En-Nesyri,MAR,FW,Sevilla,22,1997,8.8,7,5,1,6,0,3,10,30.0,7,9,3,6,5,12,7,0
150,Sergi Enrich,ESP,FW,Eibar,29,1990,20.7,17,6,4,8,5,4,21,19.0,17,16,2,14,9,26,12,0
151,Javier Eraso,ESP,MF,Leganés,29,1990,9.1,11,5,4,5,2,5,15,33.3,10,5,0,5,7,18,5,0
152,Gonzalo Escalante,ARG,MF,Eibar,26,1993,18.6,41,22,15,17,9,24,41,58.5,17,22,4,18,29,70,14,0
153,Aarón Escandell,ESP,GK,Granada,23,1995,3.0,1,1,1,0,0,1,1,100.0,0,0,0,0,0,1,0,0
154,Sergio Escudero,ESP,DF,Sevilla,29,1989,8.6,29,16,17,10,2,19,28,67.9,9,11,1,10,13,42,35,0
155,Bernardo Espinosa,COL,DF,Espanyol,30,1989,25.1,24,16,18,4,2,16,28,57.1,12,19,11,8,24,48,108,2
156,Vicente Esquerdo,ESP,MF|FW,Valencia,20,1999,0.2,1,0,1,0,0,0,0,,0,1,0,1,0,1,1,0
157,Pervis Estupiñán,ECU,DF,Osasuna,21,1998,33.1,84,45,53,27,4,42,77,54.5,35,30,7,23,58,142,61,6
158,Oghenekaro Etebo,NGA,MF,Getafe,23,1995,6.4,12,4,5,7,0,7,12,58.3,5,10,1,9,11,23,4,1
159,Beñat Etxebarria,ESP,MF,Athletic Club,32,1987,4.4,6,1,2,3,1,2,13,15.4,11,6,1,5,4,10,6,0
160,Xabier Etxeita,ESP,DF,Getafe,31,1987,16.1,20,11,11,9,0,12,23,52.2,11,9,5,4,17,37,68,0
161,Edu Expósito,ESP,MF,Eibar,22,1996,25.7,52,28,12,31,9,18,49,36.7,31,20,6,14,31,83,18,1
162,Fabricio,ESP,GK,Mallorca,31,1987,1.0,0,0,0,0,0,0,0,,0,0,0,0,0,0,0,1
163,Fayçal Fajr,MAR,MF,Getafe,30,1988,4.5,1,1,0,1,0,0,3,0.0,3,4,0,4,4,5,1,0
164,Eliseo Falcon,ESP,DF,Levante,22,1997,0.8,0,0,0,0,0,0,0,,0,0,0,0,0,0,2,0
165,Ansu Fati,ESP,FW,Barcelona,16,2002,11.4,16,8,4,7,5,5,15,33.3,10,14,1,13,8,24,3,0
166,Aleix Febas,ESP,MF|FW,Mallorca,23,1996,18.8,36,24,13,19,4,12,36,33.3,24,15,0,15,17,53,6,0
167,Zouhair Feddal,MAR,DF,Betis,30,1989,15.9,20,13,14,5,1,10,14,71.4,4,15,9,6,23,43,74,0
168,Ljubomir Fejsa,SRB,MF,Alavés,30,1988,8.7,19,13,8,10,1,6,23,26.1,17,8,1,7,6,25,13,0
169,Nabil Fekir,FRA,MF|FW,Betis,26,1993,29.3,41,26,14,19,8,12,37,32.4,25,27,3,24,10,51,3,0
170,Felipe,BRA,DF,Atlético Madrid,30,1989,23.4,27,19,21,6,0,14,24,58.3,10,18,13,5,40,67,130,0
171,João Félix,POR,FW|MF,Atlético Madrid,19,1999,19.4,9,3,3,3,3,4,14,28.6,10,4,0,4,10,19,4,1
172,Matheus Fernandes,BRA,MF|FW,Valladolid,21,1998,1.8,6,2,2,2,2,3,5,60.0,2,4,0,4,2,8,2,0
173,Aitor Fernández,ESP,GK,Levante,28,1991,36.0,1,1,1,0,0,1,1,100.0,0,0,0,0,2,3,18,3
174,Andrés Fernández,ESP,GK,Villarreal,32,1986,4.0,0,0,0,0,0,0,0,,0,0,0,0,0,0,2,0
175,Carlos Fernández,ESP,FW|MF,Granada,23,1996,24.5,24,15,7,11,6,3,32,9.4,29,25,2,23,11,35,30,0
176,Gabriel Fernández,URU,FW|MF,Celta Vigo,25,1994,6.2,1,0,0,1,0,1,3,33.3,2,5,1,4,2,3,2,0
177,Joaquín Fernández,ESP,MF|DF,Valladolid,23,1996,18.4,30,24,17,10,3,9,30,30.0,21,14,10,4,32,62,57,0
178,Fernando,BRA,MF,Sevilla,32,1987,29.5,62,33,37,24,1,34,58,58.6,24,38,15,23,67,129,73,1
179,Facundo Ferreyra,ARG,FW|MF,Espanyol,28,1991,6.4,9,4,4,5,0,3,10,30.0,7,4,0,4,2,11,5,0
180,Junior Firpo,ESP,DF,Barcelona,22,1996,11.3,23,15,12,8,3,11,17,64.7,6,15,3,12,17,40,12,1
181,Alessandro Florenzi,ITA,DF,Valencia,28,1991,8.4,13,9,9,4,0,8,18,44.4,10,11,1,10,14,27,21,0
182,Hernâni Fortes,POR,MF|FW,Levante,27,1991,7.3,5,2,4,0,1,1,3,33.3,2,3,0,3,4,9,9,0
183,Dimitri Foulquier,FRA,DF|MF,Granada,26,1993,12.4,25,11,13,9,3,11,20,55.0,9,8,3,5,16,41,32,0
184,Jorge de Frutos,ESP,MF|DF,Valladolid,22,1997,0.7,2,2,2,0,0,1,2,50.0,1,0,0,0,0,2,1,0
185,Ramiro Funes Mori,ARG,DF,Villarreal,28,1991,5.0,5,2,2,3,0,0,2,0.0,2,8,2,6,3,8,9,1
186,Enric Gallego,ESP,FW,Osasuna,32,1986,9.8,9,5,1,5,3,0,4,0.0,4,10,2,8,4,13,8,0
187,Enric Gallego,ESP,FW,Getafe,32,1986,1.8,3,1,1,1,1,2,4,50.0,2,2,0,2,2,5,1,0
188,Kévin Gameiro,FRA,FW,Valencia,32,1987,17.6,17,9,7,6,4,5,21,23.8,16,10,1,9,5,22,5,0
189,Fran Gámez,ESP,DF,Mallorca,28,1991,19.6,64,42,32,27,5,33,74,44.6,41,31,11,20,29,93,41,0
190,Ezequiel Garay,ARG,DF,Valencia,32,1986,16.0,12,8,9,2,1,7,11,63.6,4,19,17,2,14,26,71,0
191,Dani García,ESP,MF,Athletic Club,29,1990,33.7,59,30,30,27,2,30,86,34.9,56,25,7,18,52,111,56,1
192,David García,ESP,DF,Osasuna,25,1994,31.0,28,16,15,12,1,14,31,45.2,17,20,16,4,48,76,123,2
193,Javi García,ESP,MF,Betis,32,1987,4.2,2,2,2,0,0,2,3,66.7,1,1,0,1,4,6,15,0
194,Manu García,ESP,MF,Alavés,33,1986,21.9,46,23,11,31,4,17,72,23.6,55,28,12,16,28,74,32,1
195,Raúl García,ESP,DF|MF,Valladolid,30,1989,11.2,20,12,11,7,2,9,22,40.9,13,12,2,10,8,28,30,0
196,Raúl García,ESP,MF|FW,Athletic Club,33,1986,31.9,57,37,19,26,12,16,76,21.1,60,46,6,40,24,81,44,0
197,Raúl García,ESP,DF,Getafe,30,1989,2.7,5,3,2,3,0,3,6,50.0,3,3,1,2,4,9,10,0
198,Rubén García,ESP,MF|FW,Osasuna,26,1993,24.3,55,30,22,26,7,18,46,39.1,28,34,5,29,11,66,23,1
199,Unai García,ESP,DF,Osasuna,27,1992,6.0,9,6,4,4,1,5,9,55.6,4,13,9,4,8,17,31,0
200,Víctor García,ESP,FW|MF,Valladolid,22,1997,1.0,0,0,0,0,0,0,1,0.0,1,1,0,1,0,0,1,0
201,Manuel Garrido,ESP,FW,Leganés,18,2000,1.3,0,0,0,0,0,0,6,0.0,6,3,1,2,1,1,0,0
202,Mario Gaspar,ESP,DF,Villarreal,28,1990,21.8,35,20,16,16,3,15,31,48.4,16,25,10,15,26,61,69,0
203,Bryan Gil,ESP,MF|FW,Leganés,18,2001,6.2,8,4,3,4,1,1,8,12.5,7,6,0,6,3,11,1,0
204,Bryan Gil,ESP,FW,Sevilla,18,2001,0.7,1,1,0,1,0,0,1,0.0,1,0,0,0,0,1,0,0
205,Ibai Gómez,ESP,FW,Athletic Club,29,1989,7.7,5,3,2,2,1,3,8,37.5,5,4,0,4,3,8,6,0
206,Maxi Gómez,URU,FW,Valencia,22,1996,23.8,9,7,1,6,2,4,8,50.0,4,8,1,7,5,14,14,0
207,Moi Gómez,ESP,FW|MF,Villarreal,25,1994,25.8,30,22,9,14,7,11,33,33.3,22,22,2,20,25,55,23,0
208,Sergi Gómez,ESP,DF,Sevilla,27,1992,8.0,9,7,7,2,0,4,4,100.0,0,6,6,0,7,16,30,0
209,Victor Gomez,ESP,DF|FW,Espanyol,19,2000,14.1,13,5,8,4,1,7,20,35.0,13,10,0,10,21,34,31,0
210,Maxime Gonalons,FRA,MF,Granada,30,1989,16.7,62,38,25,35,2,22,54,40.7,32,27,3,24,20,82,20,1
211,Bruno González,ESP,DF,Getafe,29,1990,2.0,3,2,3,0,0,1,1,100.0,0,2,0,2,0,3,3,0
212,Bruno González,ESP,DF,Levante,29,1990,5.1,10,8,7,2,1,2,4,50.0,2,7,4,3,2,12,32,0
213,Édgar González,ESP,MF,Betis,22,1997,7.6,8,3,3,5,0,2,14,14.3,12,4,2,2,10,18,16,0
214,Gonzalo,ESP,DF,Levante,22,1997,0.1,1,0,0,1,0,0,0,,0,0,0,0,0,1,0,0
215,Andoni Gorosabel,ESP,DF,Real Sociedad,22,1996,7.9,14,8,9,3,2,10,20,50.0,10,13,1,12,13,27,21,0
216,Esteban Granero,ESP,MF,Espanyol,32,1987,5.3,10,4,5,3,2,5,11,45.5,6,3,2,1,2,12,5,0
217,Antoine Griezmann,FRA,FW,Barcelona,28,1991,28.3,33,18,12,11,10,9,34,26.5,25,22,3,19,12,45,20,1
218,Andrés Guardado,MEX,MF,Betis,32,1986,22.7,30,14,15,11,4,15,41,36.6,26,15,4,11,18,48,22,1
219,Sergi Guardiola,ESP,FW,Valladolid,28,1991,29.5,14,6,3,7,4,4,24,16.7,20,23,0,23,6,20,18,1
220,Nemanja Gudelj,SRB,MF|DF,Sevilla,27,1991,13.5,20,14,11,8,1,6,19,31.6,13,17,8,9,12,32,35,1
221,Gonçalo Guedes,POR,MF|FW,Valencia,22,1996,14.1,19,11,11,7,1,9,32,28.1,23,10,1,9,7,26,1,0
222,Adrián Guerrero,ESP,DF,Valencia,21,1998,1.4,2,2,1,1,0,2,3,66.7,1,0,0,0,2,4,1,0
223,Ander Guevara,ESP,MF,Real Sociedad,22,1997,10.4,27,11,9,17,1,12,30,40.0,18,13,3,10,8,35,15,1
224,John Guidetti,SWE,FW|MF,Alavés,27,1992,1.1,2,1,0,1,1,0,0,,0,1,0,1,0,2,0,0
225,Munir El Haddadi,MAR,FW,Sevilla,23,1995,13.9,19,17,6,11,2,4,21,19.0,17,8,0,8,7,26,8,0
226,Eden Hazard,BEL,FW|MF,Real Madrid,28,1991,12.0,7,3,2,3,2,3,15,20.0,12,5,0,5,6,13,0,0
227,Mario Hermoso,ESP,DF,Atlético Madrid,24,1995,13.5,15,8,12,2,1,11,20,55.0,9,11,5,6,12,27,61,0
228,Aridane Hernández,ESP,DF,Osasuna,30,1989,29.0,35,23,22,13,0,15,19,78.9,4,24,15,9,34,69,137,2
229,Javier Hernández,MEX,FW,Sevilla,31,1988,5.0,6,4,0,4,2,1,6,16.7,5,5,0,5,5,11,1,0
230,Juan Hernández,ESP,FW|MF,Celta Vigo,24,1994,1.0,0,0,0,0,0,0,0,,0,0,0,0,1,1,0,0
231,Héctor Herrera,MEX,MF,Atlético Madrid,29,1990,12.5,31,21,9,18,4,13,32,40.6,19,16,7,9,17,48,13,2
232,Sergio Herrera,ESP,GK,Osasuna,26,1993,18.4,1,1,1,0,0,1,4,25.0,3,0,0,0,1,2,13,3
233,Yangel Herrera,VEN,MF,Granada,21,1998,26.3,88,49,25,53,10,36,80,45.0,44,38,9,29,34,122,28,0
234,Iago Herrerín,ESP,GK,Athletic Club,31,1988,4.7,0,0,0,0,0,0,0,,0,0,0,0,0,0,0,0
235,Pablo Hervías,ESP,MF|FW,Valladolid,26,1993,11.3,24,20,8,14,2,12,22,54.5,10,8,0,8,5,29,0,0
236,Robert Ibáñez,ESP,MF|FW,Osasuna,26,1993,6.0,13,8,4,5,4,7,20,35.0,13,7,0,7,5,18,5,0
237,Vicente Iborra,ESP,MF,Villarreal,31,1988,29.4,61,42,31,25,5,30,67,44.8,37,35,16,19,40,101,63,1
238,Borja Iglesias,ESP,FW,Betis,26,1993,21.4,7,5,1,4,2,0,9,0.0,9,7,4,3,5,12,18,0
239,Asier Illarramendi,ESP,MF,Real Sociedad,29,1990,2.4,2,2,1,0,1,2,6,33.3,4,2,1,1,5,7,6,0
240,Takashi Inui,JPN,MF|FW,Eibar,31,1988,21.8,20,10,7,8,5,11,34,32.4,23,23,4,19,18,38,12,0
241,Alexander Isak,SWE,FW,Real Sociedad,19,1999,16.7,7,2,0,3,4,1,8,12.5,7,8,0,8,3,10,6,0
242,Isco,ESP,FW|MF,Real Madrid,27,1992,13.1,13,9,2,10,1,5,14,35.7,9,9,0,9,7,20,4,1
243,Ismael,ESP,MF,Betis,18,2000,0.9,2,1,1,1,0,1,2,50.0,1,2,1,1,2,4,2,0
244,Ander Iturraspe,ESP,MF,Espanyol,30,1989,2.7,2,0,1,1,0,2,5,40.0,3,0,0,0,1,3,7,0
245,Jacobo,ESP,DF|MF,Celta Vigo,22,1997,0.9,3,3,2,1,0,1,1,100.0,0,0,0,0,0,3,2,0
246,Adnan Januzaj,BEL,FW|MF,Real Sociedad,24,1995,13.0,8,7,3,2,3,3,16,18.8,13,9,1,8,7,15,2,0
247,Jason,ESP,MF,Getafe,25,1994,13.1,29,20,8,16,5,15,33,45.5,18,18,3,15,18,47,9,0
248,Joaquín,ESP,MF|FW,Betis,38,1981,22.9,14,7,4,8,2,4,11,36.4,7,10,2,8,15,29,22,1
249,Frenkie de Jong,NED,MF,Barcelona,22,1997,23.5,26,19,7,12,7,7,22,31.8,15,17,7,10,21,47,9,0
250,Luuk de Jong,NED,FW,Sevilla,28,1990,22.9,21,10,4,8,9,6,17,35.3,11,12,1,11,7,28,22,0
251,Joan Jordán,ESP,MF,Sevilla,25,1994,25.0,64,34,27,31,6,21,76,27.6,55,25,5,20,26,90,20,4
252,Willian José,BRA,FW,Real Sociedad,27,1991,22.3,5,2,0,4,1,2,8,25.0,6,10,4,6,1,6,16,0
253,Joselu,ESP,FW,Alavés,29,1990,30.9,26,17,4,12,10,4,32,12.5,28,36,5,31,13,39,46,0
254,Luka Jović,SRB,FW,Real Madrid,21,1997,4.8,2,1,0,0,2,1,2,50.0,1,1,0,1,2,4,0,0
255,Juanmi,ESP,FW|MF,Betis,26,1993,2.9,4,1,1,2,1,1,4,25.0,3,1,0,1,0,4,0,0
256,David Juncà,ESP,DF,Celta Vigo,25,1993,2.9,6,5,4,1,1,2,3,66.7,1,4,1,3,2,8,3,0
257,Lago Junior,CIV,MF|FW,Mallorca,28,1990,24.3,32,19,12,11,9,12,29,41.4,17,23,5,18,14,46,25,0
258,Vinicius Júnior,BRA,FW|MF,Real Madrid,19,2000,15.2,26,16,13,8,5,8,32,25.0,24,14,0,14,3,29,2,0
259,Lee Kang-in,KOR,MF|FW,Valencia,18,2001,5.0,3,1,0,2,1,3,6,50.0,3,5,0,5,3,6,0,0
260,Wilfrid Kaptoum,CMR,MF,Betis,23,1996,2.2,5,2,3,2,0,3,3,100.0,0,4,1,3,1,6,3,0
261,Kenedy,BRA,MF,Getafe,23,1996,6.5,9,5,3,3,3,2,5,40.0,3,10,0,10,11,20,4,0
262,Kiké,ESP,FW,Eibar,29,1989,19.6,13,7,0,5,8,4,12,33.3,8,15,1,14,1,14,9,0
263,Giorgi Kochorashvili,GEO,MF,Levante,20,1999,0.0,0,0,0,0,0,0,0,,0,0,0,0,0,0,0,0
264,Kenan Kodro,BIH,FW|MF,Athletic Club,25,1993,4.0,1,0,0,0,1,0,2,0.0,2,1,0,1,0,1,4,0
265,Koke,ESP,MF,Atlético Madrid,27,1992,30.0,70,42,27,30,13,29,89,32.6,60,33,8,25,29,99,28,2
266,Geoffrey Kondogbia,CTA,MF,Valencia,26,1993,20.1,63,40,40,18,5,19,51,37.3,32,25,6,19,57,120,36,2
267,Jules Koundé,FRA,DF,Sevilla,20,1998,25.7,23,12,14,5,4,10,18,55.6,8,16,12,4,23,46,91,2
268,Leonardo Koutris,GRE,DF,Mallorca,24,1995,1.0,1,1,0,0,1,1,2,50.0,1,1,1,0,1,2,6,0
269,İsmail Köybaşı,TUR,DF|FW,Granada,30,1989,2.6,4,4,3,1,0,0,2,0.0,2,4,0,4,5,9,2,0
270,Toni Kroos,GER,MF,Real Madrid,29,1990,29.5,56,28,18,29,9,18,70,25.7,52,27,0,27,23,79,15,0
271,Takefusa Kubo,JPN,MF|FW,Mallorca,18,2001,25.7,34,22,16,12,6,15,44,34.1,29,19,1,18,23,57,10,0
272,Víctor Laguardia,ESP,DF,Alavés,29,1989,29.5,21,15,15,6,0,16,30,53.3,14,24,18,6,37,58,131,1
273,Diego Lainez,MEX,MF|FW,Betis,19,2000,3.9,6,5,2,4,0,5,8,62.5,3,6,0,6,1,7,1,0
274,Larra,ESP,FW|MF,Athletic Club,21,1997,2.8,2,2,0,1,1,0,0,,0,1,0,1,0,2,0,0
275,Toni Lato,ESP,DF|MF,Osasuna,21,1997,5.2,22,15,11,8,3,9,10,90.0,1,9,1,8,8,30,13,1
276,Robin Le Normand,ESP,DF,Real Sociedad,22,1996,26.6,48,27,33,15,0,26,35,74.3,9,20,7,13,20,68,99,0
277,Wu Lei,CHN,FW|MF,Espanyol,27,1991,19.1,13,8,5,6,2,4,38,10.5,34,32,1,31,15,28,19,1
278,Iñigo Lekue,ESP,FW|DF,Athletic Club,26,1993,6.9,22,12,14,6,2,11,14,78.6,3,7,0,7,3,25,11,0
279,Thomas Lemar,FRA,MF,Atlético Madrid,23,1995,10.3,12,8,4,5,3,2,11,18.2,9,14,1,13,6,18,6,0
280,Clément Lenglet,FRA,DF,Barcelona,24,1995,26.9,44,31,29,15,0,16,32,50.0,16,29,15,14,35,79,79,1
281,Pedro León,ESP,MF|FW,Eibar,32,1986,21.1,28,20,8,9,11,12,25,48.0,13,18,1,17,19,47,7,0
282,Sergio León,ESP,FW,Levante,30,1989,7.5,3,3,0,3,0,2,4,50.0,2,3,0,3,1,4,2,0
283,Lillo,ESP,DF,Osasuna,30,1989,2.2,4,2,2,2,0,1,1,100.0,0,2,1,1,2,6,8,0
284,Diego Llorente,ESP,DF,Real Sociedad,25,1993,25.9,30,14,20,9,1,16,28,57.1,12,14,7,7,28,58,101,5
285,Marcos Llorente,ESP,MF|FW,Atlético Madrid,24,1995,15.2,29,15,7,16,6,7,21,33.3,14,24,4,20,14,43,9,0
286,Stanislav Lobotka,SVK,MF,Celta Vigo,24,1994,15.4,19,11,13,5,1,4,19,21.1,15,8,2,6,8,27,7,0
287,Renan Lodi,BRA,DF,Atlético Madrid,21,1998,26.6,73,46,28,35,10,40,65,61.5,25,28,7,21,38,111,56,0
288,Rony Lopes,POR,FW,Sevilla,23,1995,1.5,0,0,0,0,0,0,0,,0,0,0,0,2,2,0,0
289,Adrián López,ESP,FW,Osasuna,31,1988,16.0,7,5,1,5,1,2,19,10.5,17,6,2,4,4,11,8,0
290,David López,ESP,DF|MF,Espanyol,29,1989,27.3,38,20,15,20,3,13,41,31.7,28,28,13,15,35,73,63,3
291,Diego López,ESP,GK,Espanyol,37,1981,35.9,2,2,2,0,0,1,2,50.0,1,0,0,0,2,4,8,1
292,Javi López,ESP,DF,Alavés,17,2002,1.0,6,5,4,2,0,4,5,80.0,1,1,1,0,1,7,5,0
293,Javi López,ESP,DF,Espanyol,33,1986,15.4,47,34,23,18,6,19,40,47.5,21,12,6,6,21,68,38,2
294,Lluis López,ESP,DF,Espanyol,22,1997,3.3,4,2,3,1,0,2,2,100.0,0,4,0,4,1,5,6,1
295,Roberto López,ESP,FW|MF,Real Sociedad,19,2000,0.6,4,2,1,1,2,2,2,100.0,0,0,0,0,0,4,0,0
296,Unai López,ESP,MF,Athletic Club,23,1995,19.9,30,22,8,18,4,10,41,24.4,31,13,2,11,18,48,12,1
297,Losada,ESP,MF|FW,Celta Vigo,17,2001,0.1,0,0,0,0,0,0,0,,0,0,0,0,0,0,0,0
298,Pol Lozano,ESP,MF,Espanyol,19,1999,1.9,5,3,3,2,0,3,7,42.9,4,3,0,3,1,6,2,0
299,José Luis Gayà,ESP,DF,Valencia,24,1995,22.1,44,30,29,12,3,28,41,68.3,13,22,9,13,18,62,48,1
300,José Luis Morales,ESP,FW|MF,Levante,32,1987,28.0,17,8,5,9,3,6,34,17.6,28,14,1,13,6,23,5,1
301,José Luis Rodríguez,PAN,FW,Alavés,21,1998,0.2,0,0,0,0,0,0,2,0.0,2,0,0,0,0,0,0,0
302,Darwin Machís,VEN,FW|MF,Granada,26,1993,23.7,23,13,11,8,4,8,23,34.8,15,22,4,18,31,54,9,0
303,Lisandro Magallán,ARG,DF,Alavés,25,1993,13.3,22,15,10,12,0,8,14,57.1,6,17,6,11,16,38,43,1
304,Abdallahi Mahmoud,MTN,MF,Alavés,19,2000,1.7,4,4,2,1,1,1,6,16.7,5,0,0,0,5,9,2,0
305,Nemanja Maksimović,SRB,MF,Getafe,24,1995,32.2,49,28,12,31,6,10,44,22.7,34,37,7,30,56,105,30,1
306,Hugo Mallo,ESP,DF,Celta Vigo,28,1991,21.8,62,42,44,16,2,27,48,56.3,21,24,8,16,22,84,97,1
307,Aïssa Mandi,ALG,DF,Betis,27,1991,28.6,33,15,22,8,3,18,28,64.3,10,29,15,14,38,71,93,0
308,Eliaquim Mangala,FRA,DF,Valencia,28,1991,7.5,4,4,3,1,0,1,2,50.0,1,7,6,1,7,11,40,0
309,Marcelo,BRA,DF,Real Madrid,31,1988,14.4,19,11,8,8,3,9,28,32.1,19,19,2,17,18,37,21,0
310,Óscar de Marcos,ESP,DF|FW,Athletic Club,30,1989,6.0,5,3,2,1,2,3,6,50.0,3,6,0,6,8,13,8,0
311,Miguel Marí,ESP,MF,Eibar,22,1997,0.1,0,0,0,0,0,0,0,,0,0,0,0,0,0,0,0
312,José María Giménez,URU,DF,Atlético Madrid,24,1995,19.5,20,16,18,1,1,7,11,63.6,4,14,7,7,23,43,75,1
313,Mariano,DOM,FW|MF,Real Madrid,25,1993,0.5,0,0,0,0,0,0,1,0.0,1,0,0,0,0,0,0,0
314,Adrián Marín,ESP,DF,Alavés,22,1997,9.5,22,15,14,6,2,13,15,86.7,2,13,4,9,13,35,32,0
315,Guillermo Maripán,CHI,DF,Alavés,25,1994,1.0,1,1,1,0,0,1,2,50.0,1,0,0,0,2,3,10,0
316,Roger Martí,ESP,FW,Levante,28,1991,25.2,18,11,8,7,3,7,29,24.1,22,14,0,14,6,24,17,0
317,Daniel Martín,ESP,GK,Betis,21,1998,5.9,0,0,0,0,0,0,0,,0,0,0,0,0,0,3,0
318,Álex Martínez,ESP,DF,Granada,28,1990,0.2,0,0,0,0,0,0,0,,0,0,0,0,0,0,0,0
319,Iñigo Martínez,ESP,DF,Athletic Club,28,1991,33.0,48,30,33,13,2,27,47,57.4,20,28,13,15,39,87,140,0
320,Javi Martínez,ESP,MF,Osasuna,19,1999,0.1,0,0,0,0,0,0,0,,0,0,0,0,0,0,1,0
321,José Martínez,ESP,DF,Granada,26,1993,13.2,21,16,12,8,1,14,25,56.0,11,6,4,2,18,39,46,0
322,Pablo Martínez,ESP,MF,Levante,21,1998,0.4,2,0,1,1,0,0,1,0.0,1,0,0,0,0,2,2,0
323,Jordi Masip,ESP,GK,Valladolid,30,1989,35.0,1,1,1,0,0,0,2,0.0,2,0,0,0,1,2,7,3
324,Jaime Mata,ESP,FW,Getafe,30,1988,30.5,21,13,3,11,7,3,20,15.0,17,16,1,15,7,28,15,0
325,Borja Mayoral,ESP,FW,Levante,22,1997,23.8,12,3,4,6,2,2,13,15.4,11,11,0,11,4,16,6,0
326,Óscar Melendo,ESP,MF|FW,Espanyol,21,1997,12.4,10,4,4,4,2,4,12,33.3,8,7,2,5,2,12,3,0
327,Gonzalo Melero,ESP,MF,Levante,25,1994,13.7,20,13,9,9,2,7,27,25.9,20,12,3,9,9,29,15,1
328,Arthur Melo,BRA,MF,Barcelona,22,1996,13.1,15,10,4,7,4,4,12,33.3,8,9,0,9,4,19,5,2
329,Brais Méndez,ESP,MF|FW,Celta Vigo,22,1997,16.4,26,11,14,9,3,12,39,30.8,27,20,0,20,12,38,23,1
330,Édgar Méndez,ESP,MF|FW,Alavés,29,1990,9.6,11,7,4,6,1,5,13,38.5,8,10,2,8,5,16,7,0
331,Ferland Mendy,FRA,DF,Real Madrid,24,1995,20.1,32,26,20,9,3,14,18,77.8,4,19,5,14,22,54,30,1
332,Fran Mérida,ESP,MF,Osasuna,29,1990,12.9,27,15,11,10,6,9,27,33.3,18,15,4,11,25,52,10,0
333,Mikel Merino,ESP,MF,Real Sociedad,23,1996,34.9,79,52,20,44,15,28,86,32.6,58,46,8,38,51,130,52,0
334,Sabin Merino,ESP,FW,Leganés,27,1992,0.9,0,0,0,0,0,0,0,,0,0,0,0,0,0,0,0
335,Roque Mesa,ESP,MF,Leganés,30,1989,22.4,40,21,17,18,5,13,44,29.5,31,13,4,9,11,51,8,0
336,Lionel Messi,ARG,FW,Barcelona,32,1987,32.0,21,10,4,7,10,3,21,14.3,18,9,0,9,7,28,1,0
337,Míchel,ESP,MF,Valladolid,31,1988,24.2,50,28,26,19,5,22,75,29.3,53,22,4,18,33,83,41,1
338,Miguel,ESP,FW,Valladolid,19,1999,2.6,2,1,1,0,1,1,2,50.0,1,3,1,2,0,2,1,0
339,Éder Militão,BRA,DF,Real Madrid,21,1998,11.4,25,15,15,9,1,10,17,58.8,7,12,6,6,20,45,42,0
340,Santi Mina,ESP,FW|MF,Celta Vigo,23,1995,21.6,13,8,8,5,0,5,38,13.2,33,19,2,17,10,23,27,0
341,Jorge Miramón,ESP,DF,Levante,30,1989,27.0,52,27,35,13,4,26,45,57.8,19,30,8,22,46,98,61,1
342,Luka Modrić,CRO,MF,Real Madrid,33,1985,22.2,37,18,9,15,13,16,41,39.0,25,10,2,8,22,59,12,0
343,Jorge Molina,ESP,FW,Getafe,37,1982,21.0,8,2,0,4,4,0,12,0.0,12,13,2,11,4,12,18,0
344,Jon Moncayola,ESP,MF|DF,Osasuna,21,1998,16.6,52,30,26,22,4,27,54,50.0,27,29,5,24,16,68,23,1
345,Nacho Monreal,ESP,DF,Real Sociedad,33,1986,26.6,38,16,26,9,3,22,42,52.4,20,20,4,16,43,81,66,0
346,Joan Monterde,ESP,MF,Levante,21,1997,0.1,0,0,0,0,0,0,0,,0,0,0,0,0,0,0,0
347,Ángel Montoro,ESP,MF,Granada,31,1988,10.8,19,8,8,9,2,3,13,23.1,10,10,1,9,13,32,15,0
348,Álvaro Morata,ESP,FW,Atlético Madrid,26,1992,23.3,17,8,4,9,4,1,13,7.7,12,12,2,10,5,22,23,0
349,Alberto Moreno,ESP,DF,Villarreal,27,1992,16.3,27,16,15,11,1,9,25,36.0,16,15,3,12,25,52,36,0
350,Álex Moreno,ESP,DF,Betis,26,1993,25.2,37,20,27,8,2,12,32,37.5,20,21,8,13,23,60,47,1
351,Gerard Moreno,ESP,FW|MF,Villarreal,27,1992,30.5,19,8,4,10,5,5,46,10.9,41,19,3,16,10,29,51,0
352,Manu Morlanes,ESP,MF,Villarreal,20,1999,2.8,7,3,3,4,0,2,9,22.2,7,1,1,0,2,9,2,0
353,Loren Morón,ESP,FW,Betis,25,1993,22.6,18,12,6,7,5,9,23,39.1,14,25,6,19,9,27,13,0
354,Toni Moya,ESP,MF,Atlético Madrid,21,1998,0.0,0,0,0,0,0,0,0,,0,0,0,0,0,0,0,0
355,Javi Moyano,ESP,DF,Valladolid,33,1986,24.7,19,8,11,8,0,8,20,40.0,12,18,5,13,27,46,63,0
356,Iker Muniain,ESP,FW|MF,Athletic Club,26,1992,26.5,26,19,11,10,5,4,24,16.7,20,9,0,9,12,38,7,0
357,Aihen Muñoz,ESP,DF,Real Sociedad,21,1997,10.9,28,18,13,12,3,18,27,66.7,9,13,2,11,2,30,19,0
358,Javier Muñoz,ESP,FW|MF,Alavés,24,1995,0.6,0,0,0,0,0,0,0,,0,1,1,0,0,0,0,0
359,Jeison Murillo,COL,DF,Celta Vigo,27,1992,17.0,37,20,30,6,1,18,27,66.7,9,13,9,4,20,57,74,2
360,Nacho,ESP,DF,Valladolid,30,1989,21.0,43,22,24,15,4,17,48,35.4,31,36,8,28,25,68,61,0
361,Nacho,ESP,DF,Real Madrid,29,1990,4.9,11,6,6,3,2,6,10,60.0,4,5,3,2,12,23,18,1
362,Naldo,BRA,DF,Espanyol,30,1988,14.8,24,13,15,9,0,7,15,46.7,8,11,7,4,21,45,50,1
363,Marc Navarro,ESP,FW|DF,Leganés,24,1995,2.4,3,3,2,1,0,1,1,100.0,0,2,1,1,0,3,3,0
364,Ximo Navarro,ESP,DF,Alavés,29,1990,21.1,34,19,17,15,2,16,28,57.1,12,20,7,13,52,86,76,2
365,Jesús Navas,ESP,DF,Sevilla,33,1985,37.4,27,15,16,7,4,15,32,46.9,17,20,7,13,31,58,70,0
366,Raúl Navas,ESP,DF,Osasuna,31,1988,7.9,10,5,4,6,0,4,13,30.8,9,10,4,6,18,28,30,0
367,Neto,BRA,GK,Barcelona,30,1989,2.0,0,0,0,0,0,0,0,,0,0,0,0,0,0,1,0
368,Carlos Neva,ESP,DF,Granada,23,1996,24.5,16,11,12,3,1,9,21,42.9,12,15,2,13,28,44,60,0
369,Saúl Ñíguez,ESP,MF|DF,Atlético Madrid,24,1994,34.1,95,59,44,42,9,39,88,44.3,49,58,13,45,55,150,68,1
370,Fernando Niño,ESP,FW,Villarreal,18,2000,0.9,1,0,0,1,0,1,2,50.0,1,0,0,0,0,1,2,0
371,Nolito,ESP,FW,Sevilla,32,1986,10.0,21,12,5,11,5,7,20,35.0,13,7,0,7,1,22,1,0
372,Nolito,ESP,MF|FW,Celta Vigo,32,1986,3.6,7,5,5,2,0,3,8,37.5,5,4,1,3,1,8,4,0
373,Unai Núñez,ESP,DF,Athletic Club,22,1997,17.5,13,10,10,2,1,6,16,37.5,10,25,17,8,23,36,71,0
374,Allan Nyom,CMR,DF|MF,Getafe,31,1988,26.9,45,25,26,15,4,20,37,54.1,17,24,5,19,14,59,50,1
375,Jan Oblak,SVN,GK,Atlético Madrid,26,1993,37.7,0,0,0,0,0,0,0,,0,0,0,0,1,1,4,2
376,Rafel Obrador,ESP,DF,Mallorca,15,2004,0.0,0,0,0,0,0,0,1,0.0,1,0,0,0,0,0,1,0
377,Lucas Ocampos,ARG,FW|MF,Sevilla,25,1994,30.5,54,31,30,19,5,30,72,41.7,42,33,2,31,22,76,27,0
378,Álvaro Odriozola,ESP,DF,Real Madrid,23,1995,3.8,5,2,4,0,1,5,8,62.5,3,4,0,4,2,7,8,0
379,Lucas Olaza,URU,DF,Celta Vigo,25,1994,34.9,56,39,36,17,3,39,59,66.1,20,37,10,27,31,87,60,1
380,Oier Olazábal,ESP,GK,Espanyol,29,1989,2.0,0,0,0,0,0,0,0,,0,1,0,1,0,0,0,0
381,Kiko Olivas,ESP,DF,Valladolid,30,1988,32.7,33,16,25,7,1,13,35,37.1,22,30,16,14,61,94,112,2
382,Paulo Oliveira,POR,DF,Eibar,27,1992,23.2,31,19,22,8,1,18,30,60.0,12,23,13,10,42,73,107,1
383,Mathías Olivera,URU,DF,Getafe,21,1997,20.8,64,40,34,16,14,27,45,60.0,18,32,3,29,23,87,44,0
384,Kenneth Omeruo,NGA,DF,Leganés,25,1993,20.8,28,17,25,3,0,11,18,61.1,7,21,12,9,36,64,112,2
385,Javier Ontiveros,ESP,FW|MF,Villarreal,21,1997,9.9,29,14,13,14,2,8,35,22.9,27,13,1,12,5,34,7,0
386,Fabián Orellana,CHI,MF|FW,Eibar,33,1986,26.6,29,18,10,6,13,14,52,26.9,38,9,0,9,20,49,2,0
387,Aimar Oroz,ESP,FW,Osasuna,17,2001,0.1,0,0,0,0,0,0,0,,0,1,0,1,0,0,0,0
388,Mikel Oyarzabal,ESP,FW|MF,Real Sociedad,22,1997,33.9,36,15,13,15,8,16,46,34.8,30,32,2,30,13,49,19,1
389,Fernando Pacheco,ESP,GK,Alavés,27,1992,26.2,1,0,1,0,0,1,3,33.3,2,0,0,0,0,1,10,0
390,Jon Pacheco,ESP,DF,Real Sociedad,18,2001,0.9,0,0,0,0,0,0,0,,0,1,0,1,0,0,2,0
391,Daniel Parejo,ESP,MF,Valencia,30,1989,33.6,67,41,29,32,6,32,101,31.7,69,38,11,27,22,89,20,2
392,Miquel Parera,ESP,GK,Mallorca,23,1996,1.0,0,0,0,0,0,0,0,,0,0,0,0,0,0,0,0
393,Thomas Partey,GHA,MF,Atlético Madrid,26,1993,28.3,70,41,34,30,6,26,58,44.8,32,32,8,24,48,118,41,7
394,Paulino,ESP,FW|MF,Alavés,22,1997,0.8,0,0,0,0,0,0,1,0.0,1,1,0,1,1,1,0,0
395,Gabriel Paulista,BRA,DF,Valencia,28,1990,31.1,22,14,17,2,3,15,25,60.0,10,36,29,7,48,70,151,3
396,Alfonso Pedraza,ESP,DF,Betis,23,1996,15.0,30,19,16,11,3,19,33,57.6,14,18,6,12,16,46,26,1
397,Marc Pedraza,ESP,MF,Mallorca,32,1987,1.4,1,1,1,0,0,1,5,20.0,4,0,0,0,4,5,1,0
398,Adrià Pedrosa,ESP,DF|MF,Espanyol,21,1998,12.1,19,13,8,9,2,7,25,28.0,18,12,1,11,11,30,32,0
399,Rubén Peña,ESP,DF,Villarreal,28,1991,21.2,42,24,23,19,0,17,50,34.0,33,25,8,17,35,77,58,2
400,Luis Perea,ESP,FW,Osasuna,21,1997,0.2,0,0,0,0,0,0,0,,0,0,0,0,0,0,1,0
401,Carles Pérez,ESP,FW,Barcelona,21,1998,5.3,7,4,2,2,3,3,15,20.0,12,5,2,3,1,8,1,0
402,Iñigo Pérez,ESP,MF,Osasuna,31,1988,12.0,15,11,3,7,5,8,22,36.4,14,7,1,6,12,27,6,0
403,Juan Pérez,ESP,GK,Osasuna,23,1996,2.0,1,1,1,0,0,1,2,50.0,1,0,0,0,0,1,0,0
404,Kike Pérez,ESP,MF|FW,Valladolid,22,1997,2.4,6,1,1,3,2,3,7,42.9,4,1,0,1,10,16,4,0
405,Lucas Pérez,ESP,FW,Alavés,30,1988,27.7,12,6,2,8,2,3,13,23.1,10,13,2,11,2,14,0,0
406,Rubén Pérez,ESP,MF,Leganés,30,1989,24.4,50,27,21,23,6,16,47,34.0,31,21,4,17,38,88,33,0
407,Samu Pérez,ESP,GK,Valladolid,22,1997,0.3,0,0,0,0,0,0,0,,0,0,0,0,0,0,0,0
408,Pablo Piatti,ARG,DF|MF,Espanyol,30,1989,0.6,2,2,1,1,0,1,2,50.0,1,1,0,1,0,2,1,0
409,Cristiano Piccini,ITA,DF,Valencia,26,1992,0.8,5,4,1,0,4,4,4,100.0,0,0,0,0,2,7,1,0
410,Tomás Pina Isla,ESP,MF,Alavés,31,1987,14.9,37,22,13,21,3,12,24,50.0,12,15,5,10,16,53,31,0
411,Pipa,ESP,DF|FW,Espanyol,21,1998,5.3,9,8,5,4,0,4,6,66.7,2,8,0,8,6,15,17,0
412,Gerard Piqué,ESP,DF,Barcelona,32,1987,34.4,32,23,20,11,1,16,26,61.5,10,39,24,15,36,68,157,0
413,Óscar Plano,ESP,MF,Valladolid,28,1991,27.8,48,30,25,19,4,20,61,32.8,41,36,3,33,35,83,29,0
414,Pere Pons,ESP,MF,Alavés,26,1993,12.1,28,16,14,12,2,12,26,46.2,14,16,3,13,12,40,8,1
415,Pedro Porro,ESP,DF|MF,Valladolid,19,1999,8.2,18,10,11,7,0,10,18,55.6,8,3,0,3,7,25,19,1
416,Francisco Portillo,ESP,MF,Getafe,29,1990,4.2,11,6,3,6,2,4,12,33.3,8,2,0,2,2,13,3,0
417,Portu,ESP,FW|MF,Real Sociedad,27,1992,26.6,32,21,10,15,7,13,33,39.4,20,28,3,25,13,45,5,0
418,Sergio Postigo,ESP,DF,Levante,30,1988,26.4,32,15,23,7,2,11,18,61.1,7,24,15,9,34,66,132,1
419,Florent Poulolo,MTQ,DF,Getafe,22,1997,0.0,0,0,0,0,0,0,0,,0,0,0,0,0,0,1,0
420,Darío Poveda,ESP,MF,Atlético Madrid,22,1997,0.1,1,0,0,1,0,0,0,,0,0,0,0,0,1,0,0
421,Alejandro Pozo Pozo,ESP,DF,Mallorca,20,1999,16.6,38,24,30,6,2,19,38,50.0,19,23,2,21,23,61,29,1
422,Alejandro Pozo Pozo,ESP,MF|FW,Sevilla,20,1999,0.4,1,1,1,0,0,1,1,100.0,0,0,0,0,0,1,1,0
423,Abdón Prats,ESP,FW,Mallorca,26,1992,3.1,1,1,0,0,1,0,1,0.0,1,1,0,1,0,1,1,0
424,Antonio Puertas,ESP,FW|MF,Granada,27,1992,28.5,37,24,8,18,11,16,53,30.2,37,21,3,18,12,49,21,0
425,Riqui Puig,ESP,MF,Barcelona,19,1999,5.7,11,7,1,9,1,5,17,29.4,12,2,0,2,5,16,1,0
426,Quini,ESP,DF,Granada,29,1989,8.0,25,14,16,7,2,13,22,59.1,9,5,1,4,10,35,14,0
427,Xavi Quintillà,ESP,DF,Villarreal,22,1996,17.5,22,12,14,4,4,10,20,50.0,10,11,4,7,12,34,35,0
428,Quique,ESP,FW|MF,Eibar,29,1990,5.4,2,1,1,0,1,0,0,,0,3,0,3,0,2,3,0
429,Nemanja Radoja,SRB,MF,Levante,26,1993,22.1,43,19,27,16,0,15,46,32.6,31,21,4,17,23,66,24,0
430,Rafinha,BRA,FW|MF,Barcelona,26,1993,2.1,3,2,1,1,1,1,2,50.0,1,0,0,0,1,4,0,0
431,Rafinha,BRA,MF,Celta Vigo,26,1993,23.5,71,37,29,37,5,20,62,32.3,42,37,4,33,33,104,25,0
432,Baba Rahman,GHA,DF,Mallorca,25,1994,1.2,3,2,2,0,1,0,0,,0,2,1,1,1,4,2,0
433,Antonio Raillo,ESP,DF,Mallorca,27,1991,30.8,31,21,24,7,0,13,19,68.4,6,31,26,5,22,53,112,1
434,Ivan Rakitić,CRO,MF,Barcelona,31,1988,17.7,27,14,8,15,4,10,28,35.7,18,19,6,13,15,42,18,1
435,Sandro Ramírez,ESP,FW|MF,Valladolid,24,1995,14.5,12,10,2,6,4,2,20,10.0,18,11,1,10,7,19,2,0
436,Iván Ramis,ESP,DF,Eibar,34,1984,5.1,3,2,2,1,0,1,4,25.0,3,2,0,2,4,7,23,2
437,Adrián Ramos,COL,FW|MF,Granada,33,1986,2.5,6,2,0,2,4,2,3,66.7,1,2,0,2,1,7,1,0
438,Sergio Ramos,ESP,DF,Real Madrid,33,1986,33.5,46,31,26,17,3,20,42,47.6,22,22,9,13,49,95,102,4
439,Raúl,ESP,FW|MF,Betis,18,2000,0.2,0,0,0,0,0,0,2,0.0,2,0,0,0,0,0,0,0
440,Recio,ESP,MF,Leganés,28,1991,17.4,30,19,13,12,5,10,40,25.0,30,14,3,11,22,52,9,0
441,Sergio Reguilón,ESP,DF,Sevilla,22,1996,27.9,57,30,28,25,4,27,64,42.2,37,25,5,20,33,90,53,0
442,Manolo Reina,ESP,GK,Mallorca,34,1985,36.0,0,0,0,0,0,0,1,0.0,1,2,0,2,5,5,9,1
443,Álex Remiro,ESP,GK,Real Sociedad,24,1995,25.0,0,0,0,0,0,0,1,0.0,1,0,0,0,0,0,25,1
444,Nico Ribaudo,ESP,FW|MF,Espanyol,18,2001,2.0,3,1,1,0,2,2,6,33.3,4,1,0,1,1,4,0,0
445,Luis Rioja,ESP,MF,Alavés,25,1993,18.2,18,12,11,6,1,8,25,32.0,17,21,0,21,16,34,6,0
446,Rodrigo Riquelme,ESP,FW|MF,Atlético Madrid,19,2000,0.1,0,0,0,0,0,0,0,,0,0,0,0,0,0,0,0
447,Cristian Rivera,ESP,MF,Leganés,22,1997,3.5,6,4,3,2,1,2,4,50.0,2,4,3,1,4,10,7,0
448,Rober,ESP,DF,Levante,24,1995,2.1,3,1,2,0,1,2,2,100.0,0,0,0,0,3,6,2,0
449,Roberto,ESP,GK,Alavés,33,1986,8.8,1,1,1,0,0,1,1,100.0,0,0,0,0,0,1,2,0
450,Sergi Roberto,ESP,DF|MF,Barcelona,27,1992,26.0,35,22,16,11,8,15,25,60.0,10,12,3,9,33,68,36,0
451,Joel Robles,ESP,GK,Betis,29,1990,32.1,0,0,0,0,0,0,2,0.0,2,0,0,0,0,0,13,2
452,Marc Roca,ESP,MF,Espanyol,22,1996,33.4,82,52,29,44,9,29,82,35.4,53,28,10,18,31,113,53,2
453,Rubén Rochina,ESP,MF,Levante,28,1991,20.8,41,26,22,9,10,19,52,36.5,33,16,0,16,12,53,19,1
454,Rodrigo,ESP,FW,Valencia,28,1991,20.9,10,6,4,5,1,2,23,8.7,21,9,1,8,9,19,13,0
455,Kévin Rodrigues,POR,DF|MF,Leganés,25,1994,21.5,56,31,31,17,8,25,46,54.3,21,30,3,27,31,87,26,1
456,Kévin Rodrigues,POR,DF,Real Sociedad,25,1994,0.1,1,0,1,0,0,1,1,100.0,0,0,0,0,0,1,0,0
457,Ángel Rodríguez,ESP,FW,Getafe,32,1987,15.6,14,8,2,8,4,2,18,11.1,16,10,1,9,3,17,10,0
458,Óscar Rodríguez Arnaiz,ESP,MF|FW,Leganés,21,1998,21.3,23,10,11,7,5,13,41,31.7,28,19,0,19,14,37,13,0
459,Dani Rodríguez,ESP,MF|FW,Mallorca,31,1988,33.8,59,32,24,28,7,18,61,29.5,43,35,3,32,38,97,27,1
460,Guido Rodríguez,ARG,MF,Betis,25,1994,10.4,24,16,11,11,2,15,25,60.0,10,13,4,9,10,34,21,0
461,James Rodríguez,COL,MF|FW,Real Madrid,28,1991,4.7,17,13,6,8,3,6,12,50.0,6,3,0,3,3,20,1,0
462,Mario Rodriguez,ESP,MF,Granada,22,1997,0.0,0,0,0,0,0,0,0,,0,0,0,0,0,0,0,0
463,Rodrygo,BRA,FW,Real Madrid,18,2001,11.3,6,1,2,3,1,2,21,9.5,19,13,0,13,10,16,5,0
464,Luka Romero,ARG,FW,Mallorca,14,2004,0.1,0,0,0,0,0,0,0,,0,0,0,0,0,0,0,0
465,Facundo Roncaglia,ARG,DF,Osasuna,32,1987,14.2,24,20,12,10,2,11,20,55.0,9,18,3,15,22,46,46,0
466,Roberto Rosales,VEN,DF,Leganés,30,1988,20.8,42,23,23,17,2,19,43,44.2,24,17,4,13,30,72,48,0
467,Rubén,ESP,GK,Osasuna,35,1984,17.6,1,1,1,0,0,1,1,100.0,0,0,0,0,0,1,9,1
468,Waldo Rubio,ESP,MF|FW,Valladolid,23,1995,9.8,13,8,10,3,0,5,31,16.1,26,12,0,12,7,20,7,0
469,Aitor Ruibal,ESP,DF|MF,Leganés,23,1996,13.6,27,17,14,11,2,16,39,41.0,23,18,1,17,8,35,11,0
470,Jorge Sáenz,ESP,DF,Celta Vigo,22,1996,4.1,6,1,4,2,0,3,5,60.0,2,5,2,3,10,16,15,0
471,Borja Sainz,ESP,MF|FW,Alavés,18,2001,6.4,16,9,4,9,3,8,26,30.8,18,14,0,14,3,19,0,0
472,Yannis Salibur,FRA,MF|FW,Mallorca,28,1991,0.9,0,0,0,0,0,0,4,0.0,4,0,0,0,1,1,1,0
473,Mohammed Salisu,GHA,DF,Valladolid,20,1999,30.3,41,24,28,13,0,21,34,61.8,13,32,26,6,35,76,158,3
474,Fede San Emeterio,ESP,MF,Valladolid,22,1997,19.5,26,13,18,6,2,7,29,24.1,22,20,8,12,28,54,13,1
475,Mikel San José,ESP,MF,Athletic Club,30,1989,4.0,9,4,2,4,3,2,10,20.0,8,3,1,2,9,18,12,0
476,Oihan Sancet,ESP,MF|FW,Athletic Club,19,2000,8.2,11,7,5,4,2,4,11,36.4,7,6,0,6,2,13,2,0
477,Germán Sánchez,ESP,DF,Granada,32,1986,25.5,16,10,12,4,0,6,16,37.5,10,29,23,6,33,49,115,2
478,Javi Sánchez,ESP,DF,Valladolid,22,1997,5.5,5,4,3,2,0,1,3,33.3,2,4,2,2,4,9,24,0
479,Manu Sánchez,ESP,DF,Atlético Madrid,18,2000,3.6,13,7,2,7,4,8,15,53.3,7,3,0,3,7,20,1,0
480,Víctor Sánchez,ESP,MF,Espanyol,31,1987,18.8,66,36,36,23,7,30,71,42.3,41,31,8,23,27,93,23,1
481,Luca Sangalli,ESP,MF,Real Sociedad,24,1995,4.1,1,0,0,1,0,1,8,12.5,7,3,0,3,1,2,0,0
482,Oier Sanjurjo,ESP,MF,Osasuna,33,1986,25.8,65,34,21,34,10,28,64,43.8,36,33,8,25,35,100,39,1
483,Ivan Šaponjić,SRB,DF|FW,Atlético Madrid,21,1997,0.1,0,0,0,0,0,0,0,,0,0,0,0,0,0,0,0
484,Joan Sastre Vanrell,ESP,DF,Mallorca,22,1997,15.1,30,17,26,3,1,17,39,43.6,22,8,2,6,23,53,27,1
485,Stefan Savić,MNE,DF,Atlético Madrid,28,1991,22.0,22,17,11,10,1,11,18,61.1,7,16,9,7,24,46,91,1
486,Aleksandar Sedlar,SRB,DF,Mallorca,27,1991,9.0,13,6,10,2,1,7,11,63.6,4,17,11,6,16,29,31,0
487,Nélson Semedo,POR,DF,Barcelona,25,1993,23.3,51,30,27,18,6,21,36,58.3,15,18,3,15,22,73,30,0
488,Josep Señé,ESP,MF,Mallorca,27,1991,1.7,2,1,2,0,0,2,5,40.0,3,2,1,1,0,2,2,0
489,Salva Sevilla,ESP,MF,Mallorca,35,1984,28.5,27,21,11,16,0,9,30,30.0,21,17,5,12,29,56,17,1
490,Sidnei,BRA,DF,Betis,29,1989,13.1,23,19,17,6,0,9,14,64.3,5,15,12,3,21,44,57,0
491,Jonathan Silva,ARG,DF,Leganés,25,1994,30.9,60,34,32,22,6,27,52,51.9,25,12,4,8,34,94,46,0
492,Rui Silva,POR,GK,Granada,25,1994,35.0,2,1,2,0,0,2,2,100.0,0,0,0,0,2,4,22,3
493,Unai Simón,ESP,GK,Athletic Club,22,1997,33.2,0,0,0,0,0,0,1,0.0,1,1,0,1,1,1,10,1
494,Dimitris Siovas,GRE,DF,Leganés,30,1988,21.3,42,31,24,15,3,19,28,67.9,9,14,1,13,46,88,69,0
495,Pione Sisto,DEN,FW|MF,Celta Vigo,24,1995,9.9,17,8,5,6,6,4,19,21.1,15,18,0,18,6,23,4,1
496,Antonio Sivera,ESP,GK,Alavés,22,1996,3.0,0,0,0,0,0,0,0,,0,0,0,0,0,0,2,0
497,Fyodor Smolov,RUS,FW,Celta Vigo,29,1990,8.3,2,1,0,2,0,1,9,11.1,8,6,0,6,7,9,9,0
498,Rafa Soares,POR,DF,Eibar,24,1995,4.8,6,5,5,0,1,5,11,45.5,6,1,0,1,2,8,6,0
499,Rubén Sobrino,ESP,FW|MF,Valencia,27,1992,1.9,7,5,3,2,2,2,3,66.7,1,1,0,1,0,7,1,0
500,Roberto Soldado,ESP,FW,Granada,34,1985,26.1,16,9,2,7,7,7,24,29.2,17,16,4,12,4,20,16,0
501,Carlos Soler,ESP,MF,Valencia,22,1997,23.0,21,10,10,10,1,9,39,23.1,30,16,6,10,9,30,14,0
502,Kévin Soni,CMR,FW,Espanyol,21,1998,0.0,0,0,0,0,0,0,0,,0,0,0,0,0,0,0,0
503,David Soria,ESP,GK,Getafe,26,1993,38.0,2,1,2,0,0,2,4,50.0,2,0,0,0,3,5,17,5
504,Bruno Soriano,ESP,MF|FW,Villarreal,35,1984,2.9,4,0,1,2,1,1,1,100.0,0,4,0,4,1,5,7,0
505,Juan Soriano,ESP,GK,Leganés,21,1997,11.0,0,0,0,0,0,0,0,,0,0,0,0,0,0,1,1
506,Damián Suárez,URU,DF,Getafe,31,1988,28.8,62,32,32,21,9,38,72,52.8,34,25,2,23,27,89,41,0
507,Denis Suárez,ESP,MF|FW,Celta Vigo,25,1994,18.1,22,15,14,7,1,10,37,27.0,27,9,1,8,14,36,12,1
508,Luis Suárez,URU,FW,Barcelona,32,1987,22.2,4,0,0,1,3,2,12,16.7,10,6,1,5,1,5,11,0
509,Ki Sung-yueng,KOR,MF,Mallorca,30,1989,0.1,0,0,0,0,0,0,1,0.0,1,0,0,0,0,0,0,0
510,Suso,ESP,FW|MF,Sevilla,25,1993,8.7,9,4,4,4,1,7,16,43.8,9,6,0,6,2,11,0,0
511,Tachi,ESP,DF,Alavés,21,1997,2.6,2,1,2,0,0,1,4,25.0,3,5,4,1,4,6,12,0
512,Rodrigo Tarín,ESP,DF,Leganés,23,1996,10.6,10,7,8,2,0,9,14,64.3,5,7,3,4,9,19,51,0
513,Álvaro Tejero,ESP,DF,Eibar,23,1996,16.1,30,18,17,10,3,14,23,60.9,9,17,4,13,28,58,38,0
514,Cristian Tello,ESP,MF|FW,Betis,27,1991,8.7,8,5,2,2,4,4,8,50.0,4,5,0,5,4,12,0,0
515,Marc-André ter Stegen,GER,GK,Barcelona,27,1992,36.0,2,2,2,0,0,2,3,66.7,1,0,0,0,2,4,17,6
516,David Timor,ESP,MF|DF,Getafe,29,1989,10.5,9,6,4,5,0,5,16,31.3,11,8,3,5,18,27,23,0
517,Jean-Clair Todibo,FRA,DF,Barcelona,19,1999,0.9,1,0,1,0,0,0,1,0.0,1,0,0,0,0,1,6,0
518,Karl Toko Ekambi,CMR,FW,Villarreal,26,1992,11.0,5,3,0,3,2,1,4,25.0,3,2,0,2,3,8,2,0
519,Raúl de Tomás,ESP,FW,Espanyol,24,1994,11.9,9,7,3,4,2,4,13,30.8,9,8,1,7,10,19,4,0
520,Toño,ESP,DF,Levante,29,1989,17.7,26,19,18,7,1,15,28,53.6,13,11,3,8,13,39,34,1
521,Ferrán Torres,ESP,MF|FW,Valencia,19,2000,25.0,23,15,6,16,1,8,30,26.7,22,20,3,17,14,37,12,0
522,Óliver Torres,ESP,MF|FW,Sevilla,24,1994,17.7,45,27,12,26,7,23,60,38.3,37,23,1,22,13,58,9,1
523,Pau Torres,ESP,DF,Villarreal,22,1997,33.0,34,21,24,10,0,16,24,66.7,8,39,23,16,27,61,153,1
524,Roberto Torres,ESP,MF|FW,Osasuna,30,1989,30.2,33,16,12,18,3,21,49,42.9,28,41,2,39,31,64,37,0
525,Aleksandar Trajkovski,MKD,MF|FW,Mallorca,26,1992,3.7,2,0,1,1,0,1,7,14.3,6,2,0,2,3,5,1,0
526,Manu Trigueros,ESP,MF,Villarreal,27,1991,17.2,34,21,10,17,7,12,45,26.7,33,23,12,11,4,38,21,0
527,Kieran Trippier,ENG,DF,Atlético Madrid,28,1990,22.0,52,34,24,21,7,34,53,64.2,19,33,7,26,24,76,46,0
528,Samuel Umtiti,FRA,DF,Barcelona,25,1993,10.5,11,5,5,5,1,5,8,62.5,3,4,2,2,22,33,32,0
529,Enes Ünal,TUR,FW,Valladolid,22,1997,26.0,20,12,6,11,3,6,28,21.4,22,17,5,12,6,26,13,0
530,Tomáš Vaclík,CZE,GK,Sevilla,30,1989,32.5,0,0,0,0,0,0,1,0.0,1,0,0,0,0,0,7,0
531,Álvaro Vadillo,ESP,FW|MF,Granada,24,1994,13.5,16,11,6,8,2,9,16,56.3,7,12,0,12,7,23,2,0
532,Germán Valera,ESP,FW,Atlético Madrid,17,2002,0.0,0,0,0,0,0,0,0,,0,1,0,1,0,0,0,0
533,Martin Valjent,SVK,DF,Mallorca,23,1995,35.4,25,17,14,10,1,13,25,52.0,12,39,27,12,37,62,146,1
534,Jesús Vallejo,ESP,DF,Granada,22,1997,7.0,6,5,4,2,0,3,4,75.0,1,7,4,3,5,11,28,0
535,Manu Vallejo,ESP,MF|FW,Valencia,22,1997,4.6,7,3,0,3,4,5,9,55.6,4,4,0,4,2,9,2,0
536,Federico Valverde,URU,MF,Real Madrid,21,1998,21.2,38,19,9,19,10,12,36,33.3,24,38,4,34,21,59,12,2
537,Raphaël Varane,FRA,DF,Real Madrid,26,1993,31.4,30,17,15,14,1,12,23,52.2,11,32,16,16,31,61,124,0
538,Matías Vargas,ARG,FW|MF,Espanyol,22,1997,11.4,13,5,7,3,3,4,23,17.4,19,12,2,10,3,16,5,0
539,Franco Vázquez,ARG,MF|FW,Sevilla,30,1989,12.2,25,17,9,14,2,6,36,16.7,30,13,0,13,10,35,10,0
540,Kevin Vázquez,ESP,DF,Celta Vigo,26,1993,14.7,26,15,16,6,4,15,28,53.6,13,18,1,17,26,52,28,0
541,Lucas Vázquez,ESP,MF|FW,Real Madrid,28,1991,9.4,23,17,10,13,0,11,26,42.3,15,10,0,10,10,33,8,1
542,Koke Vegas,ESP,GK,Levante,23,1995,2.0,0,0,0,0,0,0,1,0.0,1,0,0,0,0,0,3,0
543,Unai Vencedor Paris,ESP,MF,Athletic Club,18,2000,0.8,0,0,0,0,0,0,0,,0,0,0,0,0,0,0,0
544,Mikel Vesga,ESP,MF,Athletic Club,26,1993,14.1,25,17,7,12,6,9,45,20.0,36,18,7,11,31,56,24,1
545,Rúben Vezo,POR,DF,Levante,25,1994,29.0,41,24,28,13,0,19,35,54.3,16,37,29,8,42,83,144,2
546,Fede Vico,ESP,MF|FW,Granada,25,1994,9.7,5,1,2,3,0,2,11,18.2,9,12,1,11,5,10,2,0
547,Aleix Vidal,ESP,MF,Alavés,29,1989,24.1,21,14,8,11,2,8,37,21.6,29,14,1,13,23,44,18,0
548,Arturo Vidal,CHI,MF,Barcelona,32,1987,18.6,63,38,22,30,11,24,58,41.4,34,31,7,24,17,80,16,1
549,Nacho Vidal,ESP,DF,Osasuna,24,1995,25.9,45,29,26,13,6,21,38,55.3,17,24,6,18,44,89,70,1
550,Dídac Vilà,ESP,DF,Espanyol,30,1989,27.7,73,42,44,23,6,25,61,41.0,36,31,5,26,40,113,63,0
551,Toni Villa,ESP,MF,Valladolid,24,1995,15.0,31,16,13,14,4,13,50,26.0,37,16,1,15,8,39,11,0
552,Asier Villalibre,ESP,FW,Athletic Club,21,1997,5.9,0,0,0,0,0,0,3,0.0,3,3,0,3,1,1,4,0
553,Iván Villar,ESP,GK,Celta Vigo,22,1997,3.1,0,0,0,0,0,0,0,,0,0,0,0,0,0,5,0
554,Juan Villar,ESP,FW,Osasuna,31,1988,2.7,1,0,0,1,0,0,2,0.0,2,4,1,3,1,2,0,0
555,Vitolo,ESP,FW|MF,Atlético Madrid,29,1989,13.6,15,12,7,7,1,5,17,29.4,12,9,0,9,10,25,9,0
556,Šime Vrsaljko,CRO,DF,Atlético Madrid,27,1992,4.0,6,5,6,0,0,5,6,83.3,1,5,3,2,8,14,11,0
557,Nikola Vukčević,MNE,MF,Levante,27,1991,17.4,41,26,17,17,7,15,40,37.5,25,19,7,12,12,53,16,0
558,Moussa Wagué,SEN,DF,Barcelona,20,1998,1.0,2,1,1,0,1,1,1,100.0,0,0,0,0,1,3,0,0
559,Wakaso,GHA,MF,Alavés,29,1990,14.3,54,31,25,24,5,16,33,48.5,17,23,5,18,17,71,17,1
560,Daniel Wass,DEN,DF|MF,Valencia,30,1989,30.4,44,25,25,13,6,25,57,43.9,32,22,5,17,31,75,91,1
561,Iñaki Williams,GHA,FW,Athletic Club,25,1994,32.7,15,5,0,7,8,5,18,27.8,13,18,2,16,5,20,29,0
562,Yoel,ESP,GK,Eibar,30,1988,3.0,0,0,0,0,0,0,0,,0,0,0,0,1,1,1,0
563,Okay Yokuşlu,TUR,MF,Celta Vigo,25,1994,21.9,41,27,18,21,2,20,42,47.6,22,12,5,7,28,69,71,1
564,Joseba Zaldúa,ESP,DF,Real Sociedad,27,1992,28.3,62,43,39,18,5,31,59,52.5,28,31,7,24,37,99,71,0
565,Andre-Frank Zambo Anguissa,CMR,MF,Villarreal,23,1995,28.7,76,49,29,40,7,26,78,33.3,52,42,6,36,44,120,30,0
566,Igor Zubeldia,ESP,MF|DF,Real Sociedad,22,1997,29.3,42,21,18,19,5,17,35,48.6,18,38,21,17,26,68,82,2
567,Martín Zubimendi,ESP,MF,Real Sociedad,20,1999,5.8,16,12,9,7,0,6,12,50.0,6,7,0,7,9,25,2,0
568,David Zurutuza,ESP,MF,Real Sociedad,33,1986,1.7,4,3,0,3,1,1,2,50.0,1,1,0,1,4,8,3,0
569,Martin Ødegaard,NOR,MF,Real Sociedad,20,1998,28.1,27,19,5,14,8,7,34,20.6,27,13,0,13,17,44,5,0
570,Hugo Guillamón,,DF|MF,Valencia,19,2000,5.5,,2,,,,,,,,,,,7,,,
