Rk,Player,Nation,Pos,Squad,Age,Born,90s,Tackles Tkl,Tackles TklW,Tackles Def 3rd,Tackles Mid 3rd,Tackles Att 3rd,Challenges Tkl,Challenges Att,Challenges Tkl%,Challenges Lost,Blocks Blocks,Blocks Sh,Blocks Pass,Int,Tkl+Int,Clr,Err
1,Luis Abram,PER,DF,Granada,25,1996,6.2,6,3,3,3,0,2,4,50.0,2,6,5,1,5,11,37,1
2,Marcos Acuña,ARG,DF,Sevilla,29,1991,25.1,50,29,27,14,9,30,46,65.2,16,22,5,17,14,64,25,1
3,Martin Agirregabiria,ESP,DF,Alavés,25,1996,18.0,34,22,17,11,6,18,37,48.6,19,20,3,17,25,59,38,0
4,Julen Agirrezabala,ESP,GK,Athletic Club,20,2000,4.0,0,0,0,0,0,0,0,,0,0,0,0,0,0,2,0
5,Sergio Agüero,ARG,FW,Barcelona,33,1988,1.7,1,1,0,0,1,0,2,0.0,2,0,0,0,0,1,0,0
6,Álvaro Aguirre,ESP,FW,Rayo Vallecano,21,2000,0.1,0,0,0,0,0,0,0,,0,0,0,0,0,0,0,0
7,Joseph Aidoo,GHA,DF,Celta Vigo,25,1995,29.3,39,26,28,10,1,17,31,54.8,14,23,13,10,38,77,96,3
8,Carlos Akapo,EQG,DF,Cádiz,28,1993,20.5,43,31,26,15,2,21,37,56.8,16,26,7,19,51,94,61,0
9,Ilias Akhomach,ESP,FW,Barcelona,17,2004,1.4,2,0,0,1,1,0,0,,0,0,0,0,0,2,0,0
10,Paul Akouokou,CIV,MF,Betis,23,1997,5.7,14,9,5,7,2,8,12,66.7,4,6,0,6,11,25,6,0
11,David Alaba,AUT,DF,Real Madrid,29,1992,29.4,23,13,15,6,2,9,19,47.4,10,26,15,11,22,45,70,1
12,Tomás Alarcón,CHI,MF,Cádiz,22,1999,15.8,31,20,17,10,4,10,31,32.3,21,19,7,12,30,61,31,0
13,Jordi Alba,ESP,DF,Barcelona,32,1989,29.4,47,34,12,26,9,27,47,57.4,20,26,6,20,33,80,41,1
14,Raúl Albiol,ESP,DF,Villarreal,35,1985,27.4,26,15,20,5,1,14,18,77.8,4,24,15,9,21,47,126,1
15,Paco Alcácer,ESP,FW,Villarreal,27,1993,8.7,9,3,2,4,3,1,5,20.0,4,7,0,7,6,15,1,0
16,Rubén Alcaraz,ESP,MF,Cádiz,30,1991,12.3,41,20,14,24,3,22,45,48.9,23,10,2,8,13,54,14,0
17,Omar Alderete,PAR,DF,Valencia,24,1996,26.7,53,34,34,17,2,34,53,64.2,19,30,18,12,35,88,153,0
18,Iván Alejo,ESP,MF|FW,Cádiz,26,1995,11.8,33,15,21,10,2,15,44,34.1,29,12,0,12,8,41,17,0
19,Carles Aleñá,ESP,MF,Getafe,23,1998,25.8,27,19,11,13,3,9,48,18.8,39,21,2,19,15,42,16,0
20,Hugo Álvarez,ESP,FW,Celta Vigo,18,2003,0.1,1,0,1,0,0,0,0,,0,0,0,0,0,1,1,0
21,Yeray Álvarez,ESP,DF,Athletic Club,26,1995,20.7,24,14,15,8,1,10,18,55.6,8,21,16,5,45,69,97,0
22,Dani Alves,BRA,DF,Barcelona,38,1983,12.2,30,19,13,13,4,14,26,53.8,12,10,3,7,11,41,10,2
23,Emmanuel Amankwaa Akurugu,GHA,DF,Getafe,19,2001,0.9,0,0,0,0,0,0,2,0.0,2,1,0,1,0,0,0,0
24,Amath,SEN,FW|MF,Mallorca,25,1996,9.8,21,11,11,6,4,7,17,41.2,10,12,0,12,7,28,7,0
25,Florin Andone,ROU,FW,Cádiz,28,1993,2.0,1,1,1,0,0,0,1,0.0,1,2,0,2,0,1,1,0
26,Marcos André,BRA,FW|MF,Valencia,24,1996,10.8,15,11,4,6,5,5,16,31.3,11,15,0,15,7,22,13,0
27,José Ángel,ESP,DF,Osasuna,31,1989,12.0,20,13,9,9,2,9,14,64.3,5,6,1,5,10,30,21,0
28,Josep Antoni Gayá,ESP,DF,Mallorca,21,2000,0.6,0,0,0,0,0,0,0,,0,1,0,1,1,1,3,1
29,Mauro Arambarri,URU,MF,Getafe,25,1995,29.6,62,37,19,32,11,20,68,29.4,48,35,5,30,32,94,18,0
30,Néstor Araujo,MEX,DF,Celta Vigo,29,1991,29.1,22,14,17,5,0,9,21,42.9,12,17,10,7,27,49,105,2
31,Ronald Araújo,URU,DF,Barcelona,22,1999,25.2,41,23,29,12,0,21,25,84.0,4,37,20,17,23,64,66,1
32,Jesús Areso,ESP,DF,Osasuna,22,1999,2.1,3,3,2,1,0,0,2,0.0,2,0,0,0,0,3,2,1
33,Matias Arezo,URU,FW|MF,Granada,18,2002,1.8,5,3,2,1,2,4,9,44.4,5,1,0,1,1,6,1,0
34,Santiago Arias,COL,DF,Granada,29,1992,4.9,12,5,8,3,1,4,9,44.4,5,8,4,4,5,17,10,0
35,Santiago Arzamendia,PAR,MF,Cádiz,23,1998,5.2,14,6,6,5,3,6,13,46.2,7,6,0,6,4,18,7,0
36,Sergio Asenjo,ESP,GK,Villarreal,32,1989,6.0,0,0,0,0,0,0,1,0.0,1,0,0,0,1,1,6,0
37,Alejandro Asensio,ESP,FW,Rayo Vallecano,20,2000,0.1,0,0,0,0,0,0,0,,0,0,0,0,0,0,0,0
38,Marco Asensio,ESP,FW|MF,Real Madrid,25,1996,19.2,12,8,6,4,2,4,18,22.2,14,8,1,7,12,24,6,1
39,Iago Aspas,ESP,FW,Celta Vigo,33,1987,34.3,14,7,1,5,8,4,24,16.7,20,23,2,21,11,25,19,0
40,Pierre-Emerick Aubameyang,GAB,FW,Barcelona,32,1989,12.0,2,2,0,1,1,0,5,0.0,5,9,1,8,2,4,4,0
41,Ludwig Augustinsson,SWE,DF|FW,Sevilla,27,1994,8.8,18,14,11,3,4,8,13,61.5,5,10,3,7,5,23,21,0
42,Serge Aurier,CIV,DF,Villarreal,28,1992,11.2,14,9,11,2,1,4,7,57.1,3,14,7,7,11,25,25,0
43,Ezequiel Ávila,ARG,FW|MF,Osasuna,27,1994,20.8,17,7,6,7,4,7,21,33.3,14,14,2,12,13,30,15,1
44,Iddrisu Baba,GHA,MF,Mallorca,25,1996,21.5,57,30,31,23,3,25,43,58.1,18,19,5,14,24,81,34,1
45,Carlos Bacca,COL,FW,Granada,34,1986,5.7,4,4,2,0,2,0,3,0.0,3,5,0,5,1,5,5,0
46,Édgar Badía,ESP,GK,Elche,29,1992,24.0,0,0,0,0,0,0,0,,0,0,0,0,0,0,16,2
47,Miguel Baeza,ESP,DF,Celta Vigo,21,2000,0.0,0,0,0,0,0,0,0,,0,0,0,0,0,0,0,0
48,Alejandro Balde,ESP,DF|FW,Barcelona,17,2003,2.1,2,1,1,0,1,0,0,,0,2,2,0,1,3,1,0
49,Gareth Bale,WAL,FW,Real Madrid,32,1989,3.1,2,1,1,0,1,1,4,25.0,3,2,0,2,2,4,1,0
50,Mikel Balenziaga,ESP,DF,Athletic Club,33,1988,22.5,33,24,15,15,3,25,43,58.1,18,27,4,23,21,54,79,0
51,Iván Balliu,ALB,DF,Rayo Vallecano,29,1992,35.0,45,22,25,11,9,19,31,61.3,12,24,5,19,39,84,64,0
52,Barbero,ESP,FW|MF,Osasuna,22,1998,0.2,0,0,0,0,0,0,0,,0,0,0,0,0,0,1,0
53,Barcia,ESP,DF,Granada,20,2000,0.8,0,0,0,0,0,0,0,,0,1,1,0,1,1,0,1
54,Enis Bardhi,MKD,MF|FW,Levante,26,1995,18.9,29,12,12,14,3,12,35,34.3,23,13,2,11,10,39,7,0
55,Keidi Bare,ALB,MF,Espanyol,23,1997,16.5,27,17,14,12,1,11,31,35.5,20,20,10,10,15,42,26,1
56,Kike Barja,ESP,MF|FW,Osasuna,24,1997,9.6,15,11,4,7,4,8,22,36.4,14,10,1,9,9,24,4,0
57,Antonio Barragán,ESP,DF,Elche,34,1987,11.3,21,14,13,7,1,11,17,64.7,6,5,3,2,17,38,34,0
58,Ander Barrenetxea,ESP,FW|MF,Real Sociedad,19,2001,6.1,15,10,9,6,0,8,18,44.4,10,7,0,7,2,17,2,0
59,Marc Bartra,ESP,DF,Betis,30,1991,22.1,39,14,18,17,4,19,35,54.3,16,39,22,17,33,72,105,1
60,Álvaro Bastida,ESP,MF,Cádiz,17,2004,2.2,7,4,2,4,1,4,5,80.0,1,1,0,1,3,10,1,0
61,Rodrigo Battaglia,ARG,MF,Mallorca,30,1991,13.1,32,16,13,19,0,15,30,50.0,15,21,10,11,10,42,36,0
62,Jon Bautista,ESP,MF,Real Sociedad,26,1995,0.5,3,0,0,3,0,0,1,0.0,1,1,0,1,1,4,1,0
63,Bebé,CPV,FW,Rayo Vallecano,31,1990,9.6,6,5,1,3,2,4,16,25.0,12,18,0,18,3,9,6,0
64,Héctor Bellerín,ESP,DF,Betis,26,1995,22.0,52,32,29,20,3,31,44,70.5,13,11,2,9,23,75,57,1
65,Fran Beltrán,ESP,MF,Celta Vigo,22,1999,28.9,56,41,27,23,6,28,68,41.2,40,29,5,24,32,88,39,0
66,Darío Benedetto,ARG,FW|MF,Elche,31,1990,6.6,5,1,2,2,1,3,6,50.0,3,4,0,4,1,6,1,0
67,Iker Benito,ESP,FW|MF,Osasuna,18,2002,1.3,2,1,1,0,1,0,1,0.0,1,2,0,2,0,2,2,0
68,Pedro Benito,ESP,FW,Cádiz,21,2000,0.3,0,0,0,0,0,0,1,0.0,1,0,0,0,0,0,0,0
69,Karim Benzema,FRA,FW,Real Madrid,33,1987,28.8,11,9,5,3,3,2,9,22.2,7,10,0,10,4,15,13,0
70,Yuri Berchiche,ESP,DF,Athletic Club,31,1990,11.3,25,11,10,11,4,7,14,50.0,7,19,6,13,13,38,25,0
71,Álex Berenguer,ESP,MF,Athletic Club,26,1995,24.1,45,26,23,14,8,11,51,21.6,40,40,2,38,16,61,20,0
72,Pedro Bigas,ESP,DF,Elche,30,1990,17.2,24,10,16,8,0,9,20,45.0,11,21,16,5,18,42,77,1
73,Yassine Bounou,MAR,GK,Sevilla,30,1991,31.0,0,0,0,0,0,0,0,,0,0,0,0,0,0,11,1
74,Lucas Boyé,ARG,FW,Elche,25,1996,19.0,27,13,5,15,7,9,24,37.5,15,24,1,23,2,29,23,0
75,Martin Braithwaite,DEN,FW,Barcelona,30,1991,2.6,1,1,0,0,1,0,0,,0,2,0,2,1,2,1,0
76,Darko Brašanac,SRB,MF,Osasuna,29,1992,26.7,35,22,19,14,2,14,40,35.0,26,25,8,17,25,60,15,0
77,Claudio Bravo,CHI,GK,Betis,38,1983,16.2,0,0,0,0,0,0,0,,0,0,0,0,0,0,6,2
78,Yan Brice Eteki,CMR,MF,Granada,23,1997,3.8,6,3,3,2,1,3,7,42.9,4,7,3,4,4,10,6,1
79,Ante Budimir,CRO,FW,Osasuna,30,1991,19.3,24,10,3,15,6,6,19,31.6,13,22,4,18,3,27,16,0
80,Sergio Busquets,ESP,MF,Barcelona,33,1988,35.5,93,49,31,48,14,46,83,55.4,37,44,8,36,45,138,31,0
81,Adrián Butzke,ESP,FW,Granada,22,1999,0.0,0,0,0,0,0,0,0,,0,0,0,0,0,0,0,0
82,Erick Cabaco,URU,DF,Getafe,26,1995,4.5,2,1,1,1,0,2,5,40.0,3,5,2,3,4,6,10,0
83,Leandro Cabrera,URU,DF,Espanyol,30,1991,37.0,37,24,27,10,0,21,34,61.8,13,32,23,9,44,81,222,2
84,Martín Cáceres,URU,DF,Levante,34,1987,7.4,2,2,2,0,0,1,5,20.0,4,2,2,0,11,13,16,1
85,Cala,ESP,DF,Cádiz,31,1989,10.5,9,4,9,0,0,8,17,47.1,9,12,6,6,12,21,56,0
86,Calderón,ESP,DF,Betis,21,2000,0.7,2,0,1,0,1,1,3,33.3,2,0,0,0,0,2,2,0
87,Fernando Calero,ESP,DF,Espanyol,25,1995,12.1,17,10,12,5,0,8,13,61.5,5,7,2,5,16,33,63,1
88,Víctor Camarasa,ESP,MF|FW,Betis,27,1994,1.2,2,1,1,1,0,0,1,0.0,1,2,1,1,2,4,2,0
89,Eduardo Camavinga,FRA,MF,Real Madrid,18,2002,13.7,52,35,22,20,10,20,38,52.6,18,20,2,18,17,69,14,1
90,José Campaña,ESP,MF,Levante,28,1993,15.8,27,16,13,10,4,12,32,37.5,20,13,2,11,21,48,19,1
91,Sergio Canales,ESP,FW|MF,Betis,30,1991,31.0,24,14,8,12,4,10,35,28.6,25,16,1,15,10,34,12,0
92,Álex Cantero,ESP,FW|MF,Levante,21,2000,6.8,6,4,2,3,1,1,8,12.5,7,2,0,2,1,7,0,0
93,Ander Capa,ESP,DF,Athletic Club,29,1992,0.0,0,0,0,0,0,0,0,,0,0,0,0,0,0,0,0
94,Étienne Capoue,FRA,MF,Villarreal,33,1988,25.4,44,26,18,23,3,15,28,53.6,13,17,5,12,35,79,51,0
95,Isaac Carcelen,ESP,DF|MF,Cádiz,28,1993,17.2,43,29,29,12,2,28,56,50.0,28,25,6,19,34,77,42,0
96,Cárdenas,ESP,GK,Levante,24,1997,24.0,1,1,1,0,0,0,3,0.0,3,0,0,0,1,2,19,0
97,Carlo,ESP,MF,Villarreal,20,2001,0.1,0,0,0,0,0,0,0,,0,0,0,0,0,0,0,0
98,Diego Carlos,BRA,DF,Sevilla,28,1993,32.9,35,24,20,13,2,16,24,66.7,8,48,33,15,24,59,120,5
99,Carmona,ESP,DF,Sevilla,19,2002,0.3,0,0,0,0,0,0,0,,0,0,0,0,1,1,0,0
100,Yannick Carrasco,BEL,FW|MF,Atlético Madrid,27,1993,28.7,34,19,16,12,6,19,44,43.2,25,26,5,21,19,53,12,2
101,Guido Carrillo,ARG,FW,Elche,30,1991,13.0,7,4,2,4,1,3,13,23.1,10,9,2,7,1,8,27,0
102,Dani Carvajal,ESP,DF,Real Madrid,29,1992,17.2,43,28,21,15,7,15,26,57.7,11,22,8,14,20,63,38,2
103,William Carvalho,POR,MF,Betis,29,1992,20.1,49,33,20,25,4,15,40,37.5,25,18,7,11,16,65,20,0
104,Casemiro,BRA,MF,Real Madrid,29,1992,28.5,79,51,45,30,4,30,67,44.8,37,65,19,46,38,117,65,3
105,Kiko Casilla,ESP,GK,Elche,34,1986,14.0,0,0,0,0,0,0,1,0.0,1,0,0,0,1,1,2,2
106,Catena,ESP,DF,Rayo Vallecano,26,1994,36.0,39,23,24,15,0,25,42,59.5,17,26,19,7,30,69,168,3
107,Dani Ceballos,ESP,MF,Real Madrid,24,1996,3.1,7,5,4,3,0,1,5,20.0,4,8,2,6,4,11,2,0
108,Franco Cervi,ARG,MF,Celta Vigo,27,1994,20.0,73,41,35,22,16,33,77,42.9,44,38,2,36,21,94,19,0
109,Chapela,ESP,MF|FW,Cádiz,22,1999,4.4,4,2,1,0,3,2,4,50.0,2,6,1,5,4,8,5,0
110,Chema,ESP,MF,Getafe,29,1992,0.5,0,0,0,0,0,0,1,0.0,1,0,0,0,0,0,0,0
111,Denis Cheryshev,RUS,MF|FW,Valencia,30,1990,6.3,14,5,6,1,7,6,15,40.0,9,9,1,8,9,23,9,0
112,Samuel Chukwueze,NGA,MF|FW,Villarreal,22,1999,14.8,13,9,6,5,2,3,6,50.0,3,7,0,7,5,18,4,0
113,Víctor Chust,ESP,DF,Cádiz,21,2000,20.3,19,10,14,4,1,11,17,64.7,6,20,8,12,16,35,87,0
114,Jasper Cillessen,NED,GK,Valencia,32,1989,16.2,0,0,0,0,0,0,1,0.0,1,0,0,0,1,1,6,0
115,Pathé Ciss,SEN,MF,Rayo Vallecano,27,1994,12.2,31,15,20,8,3,12,26,46.2,14,16,6,10,30,61,27,0
116,Carlos Clerc,ESP,DF,Levante,29,1992,16.8,35,17,21,10,4,7,19,36.8,12,8,3,5,26,61,32,1
117,Coke,ESP,DF,Levante,34,1987,1.3,3,2,1,1,1,3,4,75.0,1,1,0,1,2,5,7,0
118,Álex Collado,ESP,MF|FW,Granada,22,1999,11.3,27,12,6,16,5,12,31,38.7,19,28,2,26,6,33,11,0
119,Eray Cömert,SUI,DF,Valencia,23,1998,4.5,5,3,4,1,0,3,6,50.0,3,3,2,1,2,7,6,0
120,Santi Comesaña,ESP,MF,Rayo Vallecano,24,1996,29.8,87,56,45,33,9,40,104,38.5,64,46,6,40,33,120,30,0
121,Diego Conde,ESP,GK,Getafe,22,1998,0.1,0,0,0,0,0,0,0,,0,0,0,0,0,0,0,0
122,Francis Coquelin,FRA,MF,Villarreal,30,1991,9.2,26,17,9,11,6,11,20,55.0,9,15,5,10,19,45,11,0
123,Jesús Corona,MEX,FW|DF,Sevilla,28,1993,12.9,12,7,7,5,0,3,6,50.0,3,4,0,4,8,20,6,0
124,Ángel Correa,ARG,FW|MF,Atlético Madrid,26,1995,20.6,16,8,5,10,1,7,29,24.1,22,25,2,23,10,26,4,0
125,Thierry Correia,POR,DF,Valencia,22,1999,15.7,35,23,26,6,3,14,29,48.3,15,20,5,15,19,54,27,0
126,Hélder Costa,ANG,MF|FW,Valencia,27,1994,12.4,27,16,11,9,7,14,41,34.1,27,12,1,11,3,30,9,0
127,Jaume Costa,ESP,DF,Mallorca,33,1988,20.3,35,26,23,7,5,23,31,74.2,8,22,7,15,23,58,55,0
128,Thibaut Courtois,BEL,GK,Real Madrid,29,1992,36.0,1,0,1,0,0,1,2,50.0,1,0,0,0,0,1,9,1
129,Philippe Coutinho,BRA,MF|FW,Barcelona,29,1992,5.6,6,3,3,3,0,3,11,27.3,8,3,0,3,4,10,3,0
130,Cristo,ESP,DF,Real Sociedad,21,2000,0.2,0,0,0,0,0,0,0,,0,0,0,0,0,0,0,0
131,Juan Cruz Armada,ESP,DF,Osasuna,29,1992,21.5,28,21,15,12,1,8,16,50.0,8,15,12,3,16,44,58,1
132,Marc Cucurella,ESP,MF|DF,Getafe,23,1998,0.3,0,0,0,0,0,0,0,,0,0,0,0,0,0,0,0
133,Jorge Cuenca,ESP,DF,Getafe,21,1999,29.8,46,32,30,15,1,21,28,75.0,7,29,14,15,39,85,155,0
134,Matheus Cunha,BRA,FW,Atlético Madrid,22,1999,11.8,19,12,3,11,5,5,20,25.0,15,18,2,16,6,25,9,0
135,Arnaut Danjuma,NED,FW,Villarreal,24,1997,16.4,7,6,3,0,4,2,4,50.0,2,5,0,5,2,9,3,0
136,Sergi Darder,ESP,MF,Espanyol,27,1993,34.7,45,22,16,19,10,18,54,33.3,36,16,1,15,26,71,32,1
137,Rodrigo De Paul,ARG,MF,Atlético Madrid,27,1994,23.9,55,30,22,25,8,30,60,50.0,30,24,3,21,21,76,17,2
138,Thomas Delaney,DEN,MF,Sevilla,29,1991,17.2,41,24,17,21,3,16,30,53.3,14,19,10,9,13,54,35,0
139,Ousmane Dembélé,FRA,FW,Barcelona,24,1997,15.7,24,16,6,10,8,7,23,30.4,16,8,0,8,8,32,3,0
140,Yusuf Demir,AUT,FW,Barcelona,18,2003,2.1,3,1,1,1,1,2,5,40.0,3,1,0,1,2,5,1,0
141,Sergiño Dest,USA,DF|FW,Barcelona,20,2000,16.8,32,15,21,10,1,13,18,72.2,5,22,4,18,2,34,18,0
142,Boulaye Dia,SEN,FW,Villarreal,24,1996,14.1,8,6,3,4,1,2,5,40.0,3,6,1,5,5,13,4,0
143,Mouctar Diakhaby,GUI,DF,Valencia,24,1996,21.6,35,24,18,15,2,13,23,56.5,10,29,17,12,30,65,87,3
144,Javier Díaz,ESP,GK,Sevilla,24,1997,1.0,0,0,0,0,0,0,0,,0,0,0,0,0,0,0,0
145,Víctor Díaz,ESP,DF,Granada,33,1988,16.7,23,15,14,9,0,12,25,48.0,13,19,11,8,17,40,71,1
146,Landry Dimata,BEL,FW|MF,Espanyol,23,1997,6.0,2,2,1,1,0,1,4,25.0,3,0,0,0,1,3,7,0
147,Stole Dimitrievski,MKD,GK,Rayo Vallecano,27,1993,30.8,0,0,0,0,0,0,0,,0,0,0,0,1,1,14,3
148,Matías Dituro,ARG,GK,Celta Vigo,34,1987,38.0,0,0,0,0,0,0,0,,0,0,0,0,0,0,10,5
149,Djené,TOG,DF,Getafe,29,1991,34.6,44,26,24,16,4,23,34,67.6,11,24,5,19,59,103,109,2
150,Naïs Djouahra,FRA,FW|MF,Real Sociedad,21,1999,2.4,7,3,2,2,3,4,8,50.0,4,3,0,3,2,9,2,0
151,Marko Dmitrović,SRB,GK,Sevilla,29,1992,6.0,0,0,0,0,0,0,0,,0,0,0,0,0,0,3,1
152,Jaume Doménech,ESP,GK,Valencia,30,1990,3.8,0,0,0,0,0,0,0,,0,0,0,0,0,0,3,1
153,Carlos Dominguez,ESP,DF,Celta Vigo,20,2001,3.8,4,1,4,0,0,4,6,66.7,2,2,1,1,4,8,21,0
154,Mario Dominguez,ESP,FW,Valencia,17,2004,0.3,0,0,0,0,0,0,0,,0,0,0,0,0,0,1,0
155,John Donald,ESP,DF,Elche,20,2000,2.0,7,4,4,2,1,5,8,62.5,3,5,3,2,3,10,3,0
156,Domingos Duarte,POR,DF,Granada,26,1995,18.7,18,14,9,9,0,6,11,54.5,5,27,20,7,22,40,82,0
157,Óscar Duarte,CRC,DF,Levante,32,1989,19.7,18,8,12,6,0,8,23,34.8,15,18,9,9,24,42,102,0
158,Rubén Duarte,ESP,DF,Alavés,25,1995,29.1,76,47,43,27,6,43,85,50.6,42,40,6,34,57,133,82,0
159,Unai Dufur,ESP,DF,Osasuna,22,1999,1.0,0,0,0,0,0,0,0,,0,1,0,1,4,4,4,0
160,Hugo Duro,ESP,DF|MF,Getafe,21,1999,0.1,0,0,0,0,0,0,0,,0,0,0,0,0,0,0,0
161,Hugo Duro,ESP,FW|MF,Valencia,21,1999,20.4,25,19,11,13,1,15,38,39.5,23,24,2,22,4,29,20,1
162,Aritz Elustondo,ESP,DF,Real Sociedad,27,1994,23.4,21,14,16,5,0,10,20,50.0,10,19,13,6,29,50,86,0
163,Adri Embarba,ESP,FW|MF,Espanyol,29,1992,22.1,44,29,22,15,7,26,69,37.7,43,35,3,32,19,63,30,0
164,Emerson,BRA,DF,Barcelona,22,1999,1.0,3,3,2,1,0,1,2,50.0,1,1,0,1,2,5,1,0
165,Youssef En-Nesyri,MAR,FW,Sevilla,24,1997,14.2,10,5,5,2,3,4,11,36.4,7,9,1,8,4,14,18,0
166,Gonzalo Escalante,ARG,MF,Alavés,28,1993,14.4,30,14,9,20,1,13,34,38.2,21,27,2,25,21,51,28,0
167,Aarón Escandell,ESP,GK,Granada,25,1995,3.2,0,0,0,0,0,0,1,0.0,1,0,0,0,0,0,4,0
168,Sergio Escudero,ESP,DF|MF,Granada,31,1989,15.9,46,24,25,17,4,26,54,48.1,28,18,3,15,26,72,35,0
169,Alfonso Espino,URU,DF,Cádiz,29,1992,37.0,107,63,58,39,10,44,112,39.3,68,45,10,35,54,161,87,1
170,Estanis,ESP,FW,Barcelona,17,2003,0.1,1,1,0,1,0,1,1,100.0,0,0,0,0,0,1,0,0
171,Pervis Estupiñán,ECU,DF,Villarreal,23,1998,17.5,36,22,20,11,5,17,24,70.8,7,13,5,8,25,61,29,2
172,Abdessamad Ezzalzouli,MAR,FW,Barcelona,19,2001,6.4,17,9,9,5,3,5,8,62.5,3,3,0,3,9,26,0,0
173,Radamel Falcao,COL,FW,Rayo Vallecano,35,1986,9.3,2,1,0,1,1,1,4,25.0,3,4,1,3,2,4,11,0
174,Fali,ESP,DF|MF,Cádiz,27,1993,20.0,32,19,24,8,0,17,32,53.1,15,26,16,10,24,56,82,0
175,Omar Faraj,SWE,FW,Levante,19,2002,0.0,1,0,1,0,0,1,1,100.0,0,0,0,0,0,1,0,0
176,Ansu Fati,ESP,FW,Barcelona,18,2002,3.7,3,2,0,2,1,1,1,100.0,0,4,0,4,1,4,0,0
177,Aleix Febas,ESP,MF,Mallorca,25,1996,1.3,4,1,0,4,0,2,4,50.0,2,0,0,0,0,4,0,0
178,Nabil Fekir,FRA,MF,Betis,28,1993,31.0,43,29,5,25,13,7,36,19.4,29,14,0,14,7,50,7,0
179,Felipe,BRA,DF,Atlético Madrid,32,1989,16.7,20,15,11,8,1,8,18,44.4,10,17,11,6,28,48,77,0
180,João Félix,POR,FW|MF,Atlético Madrid,21,1999,14.0,5,2,1,4,0,1,5,20.0,4,4,1,3,7,12,8,0
181,Aitor Fernández,ESP,GK,Levante,30,1991,13.0,2,1,2,0,0,2,2,100.0,0,0,0,0,0,2,7,0
182,Álex Fernández,ESP,MF,Cádiz,28,1992,22.8,47,31,22,17,8,21,61,34.4,40,30,7,23,30,77,31,0
183,Fernando,BRA,MF|DF,Sevilla,34,1987,20.6,24,17,14,9,1,12,33,36.4,21,21,13,8,29,53,32,2
184,Fidel,ESP,MF,Elche,31,1989,25.1,44,23,18,17,9,14,57,24.6,43,9,1,8,7,51,20,0
185,José Fontán,ESP,DF,Celta Vigo,21,2000,3.1,5,3,3,2,0,1,5,20.0,4,3,1,2,10,15,10,0
186,Dimitri Foulquier,FRA,DF,Granada,28,1993,2.0,0,0,0,0,0,0,1,0.0,1,2,1,1,1,1,2,0
187,Dimitri Foulquier,FRA,DF,Valencia,28,1993,26.0,36,17,17,15,4,21,34,61.8,13,19,3,16,29,65,49,0
188,Juan Foyth,ARG,DF,Villarreal,23,1998,21.4,69,49,35,28,6,35,47,74.5,12,29,7,22,20,89,50,0
189,Enric Franquesa,ESP,DF|FW,Levante,24,1997,6.9,5,3,4,0,1,0,1,0.0,1,4,0,4,7,12,11,0
190,Jorge de Frutos,ESP,MF|FW,Levante,24,1997,19.6,33,15,14,11,8,10,51,19.6,41,11,1,10,12,45,13,0
191,Javi Galán,ESP,DF,Celta Vigo,26,1994,36.6,108,66,60,37,11,42,99,42.4,57,48,8,40,45,153,52,0
192,Iñigo Ruiz de Galarreta,ESP,MF,Mallorca,27,1993,15.3,40,21,14,21,5,14,30,46.7,16,16,2,14,20,60,21,0
193,Thiago Galhardo,BRA,FW|MF,Celta Vigo,32,1989,12.8,12,6,3,3,6,2,12,16.7,10,15,2,13,6,18,9,0
194,Álvaro García,ESP,FW|MF,Rayo Vallecano,28,1992,33.3,42,23,15,18,9,8,35,22.9,27,27,3,24,42,84,24,0
195,Dani García,ESP,MF,Athletic Club,31,1990,24.2,36,22,15,17,4,14,47,29.8,33,27,10,17,24,60,41,1
196,David García,ESP,DF,Osasuna,27,1994,34.5,28,14,15,11,2,12,22,54.5,10,27,21,6,52,80,168,0
197,Eric García,ESP,DF,Barcelona,20,2001,22.7,27,18,13,13,1,11,26,42.3,15,22,12,10,44,71,53,3
198,Fran Garcia,ESP,DF,Rayo Vallecano,21,1999,33.6,60,35,44,12,4,39,73,53.4,34,34,8,26,45,105,53,0
199,Joan García,ESP,GK,Espanyol,20,2001,1.2,0,0,0,0,0,0,0,,0,0,0,0,1,1,1,2
200,Manu García,ESP,MF,Alavés,23,1998,12.0,18,9,6,9,3,9,27,33.3,18,8,2,6,13,31,4,0
201,Raúl García,ESP,FW,Athletic Club,35,1986,20.0,27,17,6,11,10,8,36,22.2,28,30,4,26,9,36,21,0
202,Rubén García,ESP,MF|FW,Osasuna,28,1993,26.4,43,26,12,23,8,16,49,32.7,33,31,4,27,24,67,16,0
203,Saúl García,ESP,MF,Alavés,26,1994,0.0,1,1,1,0,0,0,0,,0,0,0,0,0,1,0,0
204,Unai García,ESP,DF,Osasuna,29,1992,15.6,21,12,14,6,1,14,17,82.4,3,19,11,8,22,43,78,0
205,Mario Gaspar,ESP,DF,Villarreal,30,1990,6.9,10,4,2,5,3,6,10,60.0,4,6,3,3,6,16,15,0
206,Gavi,ESP,MF|FW,Barcelona,16,2004,25.7,38,18,13,18,7,9,33,27.3,24,36,0,36,25,63,13,0
207,Bryan Gil,ESP,MF|FW,Valencia,20,2001,8.4,13,8,6,3,4,2,13,15.4,11,13,0,13,1,14,4,0
208,Óscar Gil,ESP,DF,Espanyol,24,1997,18.8,52,35,27,20,5,25,46,54.3,21,33,9,24,19,71,33,2
209,Mario Gila,ESP,DF,Real Madrid,20,2000,0.3,1,0,1,0,0,0,1,0.0,1,0,0,0,1,2,1,0
210,Dani Gómez,ESP,FW,Levante,23,1998,11.8,7,4,3,2,2,4,12,33.3,8,3,0,3,3,10,5,0
211,Maxi Gómez,URU,FW,Valencia,24,1996,21.7,5,3,1,2,2,5,8,62.5,3,5,1,4,3,8,22,0
212,Moi Gómez,ESP,MF|FW,Villarreal,27,1994,14.3,15,7,8,3,4,5,17,29.4,12,5,0,5,6,21,6,0
213,Papu Gómez,ARG,FW|MF,Sevilla,33,1988,19.8,19,11,9,5,5,9,35,25.7,26,15,2,13,7,26,12,2
214,Sergi Gómez,ESP,DF,Espanyol,29,1992,30.2,33,24,29,3,1,18,27,66.7,9,33,23,10,40,73,125,2
215,Victor Gomez,ESP,DF,Espanyol,21,2000,0.0,0,0,0,0,0,0,0,,0,0,0,0,0,0,0,0
216,Maxime Gonalons,FRA,MF,Granada,32,1989,17.2,43,28,17,22,4,14,39,35.9,25,33,10,23,18,61,29,0
217,Diego González,ESP,DF,Elche,26,1995,19.9,25,16,18,7,0,9,16,56.3,7,21,13,8,19,44,87,0
218,Édgar González,ESP,DF,Betis,24,1997,16.3,25,19,15,8,2,17,24,70.8,7,17,11,6,23,48,82,0
219,Giovanni González,URU,DF,Mallorca,26,1994,4.1,9,3,4,4,1,3,5,60.0,2,7,2,5,4,13,14,0
220,Nicolás González,ESP,MF,Barcelona,19,2002,12.4,31,20,5,23,3,11,27,40.7,16,12,0,12,6,37,12,0
221,Peter González,DOM,MF|DF,Real Madrid,19,2002,0.3,0,0,0,0,0,0,0,,0,0,0,0,1,1,0,0
222,Roberto González,ESP,FW|MF,Betis,20,2001,1.5,5,4,3,2,0,4,6,66.7,2,5,0,5,1,6,1,0
223,Gori,ESP,MF,Espanyol,19,2002,0.1,0,0,0,0,0,0,0,,0,2,0,2,0,0,0,0
224,Andoni Gorosabel,ESP,DF,Real Sociedad,24,1996,25.4,47,31,32,9,6,25,47,53.2,22,16,3,13,18,65,49,0
225,Jaume Grau,ESP,MF,Osasuna,24,1997,0.0,1,1,1,0,0,0,1,0.0,1,0,0,0,0,1,0,0
226,Dominik Greif,SVK,GK,Mallorca,24,1997,1.0,0,0,0,0,0,0,0,,0,0,0,0,0,0,0,0
227,Clément Grenier,FRA,MF,Mallorca,30,1991,0.7,0,0,0,0,0,0,0,,0,1,1,0,0,0,1,0
228,Antoine Griezmann,FRA,FW,Barcelona,30,1991,2.9,13,5,3,10,0,2,6,33.3,4,4,0,4,3,16,5,0
229,Antoine Griezmann,FRA,FW|MF,Atlético Madrid,30,1991,18.8,30,14,11,15,4,12,32,37.5,20,18,1,17,7,37,18,0
230,Andrés Guardado,MEX,MF,Betis,34,1986,15.5,30,13,12,17,1,13,34,38.2,21,18,4,14,21,51,29,1
231,Sergi Guardiola,ESP,FW,Rayo Vallecano,30,1991,19.0,10,9,3,5,2,1,21,4.8,20,14,2,12,4,14,17,0
232,Nemanja Gudelj,SRB,DF|MF,Sevilla,29,1991,11.6,16,7,10,4,2,5,8,62.5,3,14,9,5,22,38,37,0
233,Gonçalo Guedes,POR,FW|MF,Valencia,24,1996,29.0,21,14,6,7,8,2,22,9.1,20,14,0,14,9,30,1,0
234,Ander Guevara,ESP,MF,Real Sociedad,24,1997,9.6,18,13,6,10,2,10,17,58.8,7,12,6,6,12,30,8,0
235,John Guidetti,SWE,FW|MF,Alavés,29,1992,3.1,2,1,0,0,2,0,1,0.0,1,1,0,1,0,2,0,0
236,Gerard Gumbau,ESP,MF,Elche,26,1994,21.0,46,19,22,19,5,22,51,43.1,29,18,4,14,23,69,25,0
237,Jon Guridi,ESP,MF,Real Sociedad,26,1995,2.3,5,3,2,3,0,1,4,25.0,3,3,1,2,3,8,4,0
238,Raúl Guti,ESP,MF,Elche,24,1996,18.1,25,15,7,14,4,10,30,33.3,20,9,3,6,25,50,7,0
239,Marcos Mauro López Gutiérrez,ARG,DF,Cádiz,30,1991,1.5,1,0,0,1,0,0,2,0.0,2,2,1,1,1,2,9,0
240,Miguel Gutiérrez,ESP,DF,Real Madrid,20,2001,2.9,7,5,5,0,2,3,5,60.0,2,0,0,0,2,9,2,0
241,Munir El Haddadi,MAR,FW|MF,Sevilla,25,1995,5.3,8,4,1,6,1,2,8,25.0,6,7,1,6,5,13,2,0
242,Varazdat Haroyan,ARM,DF,Cádiz,28,1992,16.0,31,21,20,10,1,19,29,65.5,10,22,12,10,15,46,62,0
243,Eden Hazard,BEL,FW|MF,Real Madrid,30,1991,8.0,6,3,3,2,1,3,7,42.9,4,3,0,3,2,8,0,0
244,Kike Hermoso,ESP,DF,Betis,21,1999,1.0,2,1,2,0,0,2,2,100.0,0,2,1,1,0,2,5,1
245,Mario Hermoso,ESP,DF,Atlético Madrid,26,1995,20.7,30,15,23,4,3,20,38,52.6,18,18,3,15,29,59,49,2
246,Aridane Hernández,ESP,DF,Osasuna,32,1989,12.9,12,9,10,2,0,3,13,23.1,10,11,9,2,20,32,71,0
247,Luis Hernández,ESP,DF,Cádiz,32,1989,15.2,9,5,9,0,0,5,8,62.5,3,5,3,2,16,25,34,0
248,Mario Hernández,ESP,DF|FW,Rayo Vallecano,22,1999,4.4,10,4,7,3,0,5,9,55.6,4,1,0,1,4,14,7,0
249,Héctor Herrera,MEX,MF,Atlético Madrid,31,1990,9.5,16,8,11,4,1,7,20,35.0,13,13,2,11,12,28,16,0
250,Sergio Herrera,ESP,GK,Osasuna,28,1993,36.0,3,2,3,0,0,3,6,50.0,3,1,0,1,1,4,18,0
251,Yangel Herrera,VEN,MF,Espanyol,23,1998,18.3,41,31,19,19,3,18,39,46.2,21,27,5,22,19,60,33,1
252,Matthew Hoppe,USA,FW|MF,Mallorca,20,2001,1.5,1,0,0,0,1,0,3,0.0,3,0,0,0,0,1,0,0
253,Robert Ibáñez,ESP,MF|FW,Osasuna,28,1993,1.0,3,3,2,0,1,1,2,50.0,1,1,0,1,1,4,1,0
254,Vicente Iborra,ESP,MF,Villarreal,33,1988,11.5,19,10,9,7,3,12,24,50.0,12,11,5,6,11,30,27,1
255,Oussama Idrissi,MAR,MF|FW,Sevilla,25,1996,1.4,1,0,0,1,0,0,1,0.0,1,1,0,1,1,2,1,0
256,Oussama Idrissi,MAR,MF,Cádiz,25,1996,10.0,8,4,3,4,1,4,15,26.7,11,8,0,8,3,11,5,0
257,Iglesias,ESP,DF,Getafe,23,1998,8.0,19,10,11,8,0,7,17,41.2,10,8,2,6,10,29,28,0
258,Borja Iglesias,ESP,FW,Betis,28,1993,17.5,6,4,1,2,3,0,8,0.0,8,11,1,10,4,10,7,0
259,Asier Illarramendi,ESP,MF,Real Sociedad,31,1990,4.2,9,5,5,3,1,1,10,10.0,9,5,1,4,4,13,12,0
260,Nikita Iosifov,RUS,MF,Villarreal,20,2001,0.0,0,0,0,0,0,0,0,,0,0,0,0,0,0,0,0
261,Alexander Isak,SWE,FW,Real Sociedad,21,1999,23.8,7,4,1,3,3,2,12,16.7,10,14,2,12,3,10,10,0
262,Isco,ESP,MF|FW,Real Madrid,29,1992,3.7,9,5,4,4,1,5,12,41.7,7,1,0,1,2,11,1,0
263,Nicolas Jackson,SEN,FW|MF,Villarreal,20,2001,1.8,2,0,1,0,1,0,0,,0,0,0,0,1,3,1,0
264,Jakub Jankto,CZE,DF|MF,Getafe,25,1996,6.5,11,7,5,5,1,10,17,58.8,7,4,0,4,4,15,7,0
265,Adnan Januzaj,BEL,FW|MF,Real Sociedad,26,1995,18.1,17,11,5,8,4,9,24,37.5,15,15,3,12,12,29,15,0
266,Jason,ESP,MF|FW,Alavés,27,1994,7.5,11,7,6,4,1,7,20,35.0,13,7,0,7,7,18,5,0
267,Jason,ESP,MF|DF,Valencia,27,1994,0.8,4,1,2,1,1,0,1,0.0,1,2,0,2,1,5,1,0
268,Luis Javier Suárez,COL,FW,Granada,23,1997,31.6,26,14,9,9,8,8,27,29.6,19,25,3,22,6,32,23,0
269,Álvaro Jiménez,ESP,MF|FW,Cádiz,26,1995,2.6,6,3,3,2,1,4,7,57.1,3,3,0,3,3,9,0,0
270,Joaquín,ESP,FW|MF,Betis,40,1981,5.2,6,2,4,2,0,3,8,37.5,5,5,2,3,3,9,10,0
271,Jofre,ESP,MF|DF,Espanyol,20,2001,0.2,1,1,0,0,1,1,1,100.0,0,0,0,0,0,1,0,0
272,Frenkie de Jong,NED,MF,Barcelona,24,1997,27.5,35,19,12,18,5,12,23,52.2,11,19,5,14,20,55,16,0
273,Luuk de Jong,NED,FW,Barcelona,30,1990,7.3,9,7,1,5,3,1,2,50.0,1,4,0,4,0,9,12,0
274,Joan Jordán,ESP,MF,Sevilla,27,1994,27.9,61,30,22,31,8,28,65,43.1,37,27,6,21,30,91,18,1
275,Josan,ESP,DF|MF,Elche,31,1989,13.5,36,22,23,9,4,26,44,59.1,18,11,4,7,10,46,21,0
276,Willian José,BRA,FW,Betis,29,1991,17.8,15,13,2,10,3,2,8,25.0,6,10,2,8,3,18,16,0
277,Joselu,ESP,FW,Alavés,31,1990,34.7,16,11,1,9,6,7,25,28.0,18,21,4,17,7,23,45,0
278,Josema,ESP,DF,Elche,25,1996,2.0,3,2,1,1,1,0,2,0.0,2,1,1,0,0,3,11,0
279,Luka Jović,SRB,FW,Real Madrid,23,1997,4.1,1,1,0,1,0,0,1,0.0,1,3,0,3,1,2,4,0
280,Miguel Juan Llambrich,ESP,DF,Espanyol,25,1996,0.8,2,2,1,1,0,0,0,,0,1,0,1,0,2,5,0
281,José Juan Macías,MEX,FW|MF,Getafe,21,1999,2.2,1,0,0,0,1,0,1,0.0,1,1,0,1,1,2,0,0
282,Juanmi,ESP,FW,Betis,28,1993,23.7,39,25,11,19,9,19,49,38.8,30,24,1,23,9,48,10,1
283,Lago Junior,CIV,FW|MF,Mallorca,30,1990,2.0,3,2,3,0,0,3,5,60.0,2,0,0,0,2,5,2,0
284,Vinicius Júnior,BRA,FW,Real Madrid,21,2000,29.9,46,24,23,19,4,15,50,30.0,35,25,0,25,6,52,6,0
285,Jutglà,ESP,FW,Barcelona,22,1999,3.3,2,1,0,1,1,0,1,0.0,1,2,0,2,1,3,1,0
286,Jens Jønsson,DEN,MF,Cádiz,28,1993,14.5,40,29,22,17,1,17,35,48.6,18,17,7,10,34,74,32,0
287,Lee Kang-in,KOR,MF|FW,Mallorca,20,2001,15.7,13,6,2,9,2,5,29,17.2,24,11,1,10,5,18,7,0
288,Kiké,ESP,FW,Osasuna,31,1989,20.7,11,7,3,4,4,3,23,13.0,20,10,1,9,3,14,12,0
289,Koba Koindredi,FRA,MF,Valencia,19,2001,2.0,4,3,2,1,1,2,6,33.3,4,3,0,3,4,8,5,0
290,Koke,ESP,MF,Atlético Madrid,29,1992,27.9,55,30,19,29,7,26,63,41.3,37,21,5,16,24,79,31,1
291,Luca Koleosho,ITA,FW,Espanyol,16,2004,0.0,0,0,0,0,0,0,0,,0,0,0,0,0,0,0,0
292,Geoffrey Kondogbia,CTA,MF|DF,Atlético Madrid,28,1993,20.9,74,44,25,40,9,21,49,42.9,28,16,5,11,44,118,24,0
293,Jules Koundé,FRA,DF,Sevilla,22,1998,30.4,40,17,27,10,3,18,28,64.3,10,33,18,15,21,61,101,2
294,Toni Kroos,GER,MF,Real Madrid,31,1990,23.4,34,26,13,17,4,14,36,38.9,22,16,3,13,12,46,13,1
295,Takefusa Kubo,JPN,FW|MF,Mallorca,20,2001,17.8,31,19,12,14,5,10,24,41.7,14,24,3,21,8,39,4,0
296,Víctor Laguardia,ESP,DF,Alavés,31,1989,33.8,29,16,21,8,0,19,30,63.3,11,36,24,12,27,56,151,1
297,Diego Lainez,MEX,FW,Betis,21,2000,1.6,1,1,0,1,0,0,3,0.0,3,3,0,3,1,2,0,0
298,Érik Lamela,ARG,FW|MF,Sevilla,29,1992,11.3,31,18,12,14,5,10,29,34.5,19,11,0,11,5,36,3,0
299,Juanmi Latasa,ESP,FW,Real Madrid,20,2001,0.1,0,0,0,0,0,0,0,,0,0,0,0,0,0,0,0
300,Toni Lato,ESP,DF,Valencia,23,1997,6.6,17,12,12,3,2,9,16,56.3,7,6,0,6,8,25,14,0
301,Robin Le Normand,ESP,DF,Real Sociedad,24,1996,37.0,49,32,36,8,5,28,36,77.8,8,34,22,12,48,97,125,0
302,Jeremías Ledesma,ARG,GK,Cádiz,28,1993,38.0,3,1,3,0,0,3,4,75.0,1,0,0,0,1,4,21,4
303,Wu Lei,CHN,FW|MF,Espanyol,29,1991,5.3,3,2,1,2,0,3,8,37.5,5,4,0,4,4,7,3,0
304,Florian Lejeune,FRA,DF,Alavés,30,1991,30.0,33,24,22,10,1,12,20,60.0,8,30,19,11,31,64,158,0
305,Iñigo Lekue,ESP,DF,Athletic Club,28,1993,21.4,32,23,16,12,4,22,44,50.0,22,37,12,25,23,55,63,0
306,Thomas Lemar,FRA,MF,Atlético Madrid,25,1995,16.0,24,14,9,12,3,8,23,34.8,15,18,0,18,8,32,11,0
307,Ruben Lendinez,ESP,DF,Valencia,18,2003,1.5,3,3,1,2,0,3,8,37.5,5,4,0,4,2,5,6,0
308,Clément Lenglet,FRA,DF,Barcelona,26,1995,9.2,20,11,11,7,2,8,13,61.5,5,7,3,4,13,33,21,0
309,Javier Llabrés,ESP,FW|MF,Mallorca,18,2002,1.5,2,1,0,1,1,1,2,50.0,1,1,0,1,0,2,0,0
310,Marcos Llorente,ESP,MF|DF,Atlético Madrid,26,1995,27.2,51,23,25,22,4,28,43,65.1,15,33,10,23,27,78,44,0
311,Giovani Lo Celso,ARG,FW|MF,Villarreal,25,1996,11.0,22,12,8,10,4,9,22,40.9,13,4,0,4,5,27,3,0
312,Julen Lobete,ESP,FW|MF,Real Sociedad,20,2000,3.2,4,3,3,0,1,1,2,50.0,1,6,1,5,1,5,1,0
313,Renan Lodi,BRA,DF,Atlético Madrid,23,1998,13.1,31,18,14,13,4,11,27,40.7,16,22,4,18,13,44,19,1
314,David López,ESP,MF|DF,Espanyol,31,1989,8.3,18,13,9,8,1,9,16,56.3,7,10,8,2,10,28,25,2
315,Diego López,ESP,GK,Espanyol,39,1981,35.3,0,0,0,0,0,0,2,0.0,2,0,0,0,1,1,21,1
316,Javi López,ESP,DF,Alavés,19,2002,5.1,8,6,6,2,0,4,6,66.7,2,7,1,6,4,12,15,0
317,Unai López,ESP,MF,Rayo Vallecano,25,1995,12.9,19,9,6,10,3,10,33,30.3,23,7,0,7,10,29,8,1
318,Anthony Lozano,HON,FW|MF,Cádiz,28,1993,18.6,8,4,2,3,3,5,18,27.8,13,16,2,14,2,10,7,0
319,Florentino Luís,POR,MF,Getafe,21,1999,11.0,42,25,22,17,3,17,35,48.6,18,21,2,19,21,63,11,1
320,José Luis Gayà,ESP,DF,Valencia,26,1995,20.8,35,21,24,10,1,16,34,47.1,18,17,3,14,19,54,37,0
321,José Luis Morales,ESP,FW|MF,Levante,34,1987,30.2,27,17,6,9,12,12,42,28.6,30,29,0,29,4,31,7,0
322,Luismi,ESP,FW|MF,Sevilla,20,2001,0.1,0,0,0,0,0,0,0,,0,0,0,0,0,0,0,0
323,Andriy Lunin,UKR,GK,Real Madrid,22,1999,2.0,0,0,0,0,0,0,0,,0,0,0,0,0,0,2,0
324,Darwin Machís,VEN,MF|FW,Granada,28,1993,15.3,23,13,11,8,4,9,23,39.1,14,10,0,10,15,38,17,0
325,Pablo Maffeo,ESP,DF,Mallorca,24,1997,32.7,84,47,48,28,8,38,69,55.1,31,30,13,17,46,130,74,0
326,Nemanja Maksimović,SRB,MF,Getafe,26,1995,32.6,56,32,24,26,6,18,49,36.7,31,42,13,29,71,127,41,0
327,Hugo Mallo,ESP,DF,Celta Vigo,30,1991,20.3,45,25,24,19,2,16,31,51.6,15,23,9,14,20,65,53,0
328,Mickael Malsa,MTQ,MF,Levante,25,1995,12.7,37,17,16,18,3,15,42,35.7,27,20,8,12,18,55,15,0
329,Giorgi Mamardashvili,GEO,GK,Valencia,20,2000,18.0,0,0,0,0,0,0,0,,0,0,0,0,0,0,6,1
330,Reinildo Mandava,MOZ,DF,Atlético Madrid,27,1994,14.4,45,25,30,14,1,22,30,73.3,8,18,9,9,21,66,38,0
331,Aïssa Mandi,ALG,DF,Villarreal,29,1991,15.3,11,5,2,8,1,3,6,50.0,3,17,14,3,13,24,49,3
332,Nikola Maraš,SRB,DF,Rayo Vallecano,25,1995,11.6,13,9,12,1,0,9,15,60.0,6,17,13,4,15,28,51,0
333,Marcelo,BRA,DF,Real Madrid,33,1988,5.8,8,4,2,3,3,5,10,50.0,5,7,2,5,1,9,11,0
334,Iván Marcone,ARG,MF,Elche,31,1990,9.0,24,14,17,6,1,12,24,50.0,12,8,3,5,12,36,13,0
335,Óscar de Marcos,ESP,DF,Athletic Club,32,1989,18.7,50,37,24,19,7,28,43,65.1,15,20,3,17,19,69,27,0
336,José Mari,ESP,MF,Cádiz,33,1987,4.3,14,7,3,10,1,7,8,87.5,1,4,1,3,7,21,2,0
337,José María Giménez,URU,DF,Atlético Madrid,26,1995,22.7,18,12,12,6,0,8,16,50.0,8,25,19,6,25,43,96,1
338,Mariano,DOM,FW,Real Madrid,27,1993,3.8,2,0,2,0,0,0,0,,0,2,0,2,1,3,3,0
339,Mika Màrmol,ESP,DF,Barcelona,19,2002,0.0,0,0,0,0,0,0,0,,0,0,0,0,0,0,0,0
340,Roger Martí,ESP,FW,Levante,30,1991,23.5,23,14,3,13,7,8,30,26.7,22,14,0,14,2,25,8,0
341,Anthony Martial,FRA,FW|MF,Sevilla,25,1995,5.4,2,1,0,0,2,2,6,33.3,4,4,0,4,0,2,3,0
342,Martín,ESP,MF,Cádiz,22,1999,1.3,2,2,0,2,0,0,0,,0,1,0,1,1,3,3,0
343,Ander Martin,ESP,FW|MF,Real Sociedad,20,2000,1.0,1,0,0,1,0,1,1,100.0,0,0,0,0,3,4,1,0
344,Andrés Martín,ESP,FW|MF,Rayo Vallecano,22,1999,2.1,0,0,0,0,0,0,1,0.0,1,1,0,1,0,0,0,0
345,Carlos Martín,ESP,DF,Atlético Madrid,19,2002,0.1,0,0,0,0,0,0,0,,0,0,0,0,0,0,1,0
346,Iván Martín,ESP,MF|FW,Alavés,22,1999,1.8,1,1,1,0,0,0,1,0.0,1,2,0,2,1,2,1,0
347,Iñigo Martínez,ESP,DF,Athletic Club,30,1991,26.0,28,13,18,7,3,14,23,60.9,9,22,10,12,39,67,143,0
348,Javi Martínez,ESP,MF|FW,Osasuna,21,1999,9.8,21,14,8,11,2,10,29,34.5,19,6,0,6,9,30,10,0
349,Pablo Martínez,ESP,MF,Levante,23,1998,7.3,15,8,7,8,0,4,13,30.8,9,6,3,3,15,30,5,0
350,Omar Mascarell,ESP,MF,Elche,28,1993,27.7,46,26,16,23,7,24,60,40.0,36,42,14,28,48,94,52,2
351,Jaime Mata,ESP,FW,Getafe,32,1988,7.5,7,5,3,1,3,1,9,11.1,8,4,1,3,1,8,5,0
352,Luís Maximiano,POR,GK,Granada,22,1999,34.8,3,1,3,0,0,3,6,50.0,3,0,0,0,1,4,16,2
353,Borja Mayoral,ESP,FW,Getafe,24,1997,11.6,7,5,2,3,2,1,2,50.0,1,10,4,6,4,11,3,0
354,Jordi Mboula,ESP,FW,Mallorca,22,1999,4.8,8,2,3,3,2,5,9,55.6,4,7,1,6,3,11,3,0
355,Óscar Melendo,ESP,MF|FW,Espanyol,23,1997,11.0,11,5,4,4,3,3,13,23.1,10,4,1,3,1,12,10,0
356,Gonzalo Melero,ESP,MF,Levante,27,1994,18.8,29,16,10,15,4,16,36,44.4,20,21,8,13,7,36,22,0
357,Memphis,NED,FW,Barcelona,27,1994,20.6,10,4,2,4,4,3,13,23.1,10,9,1,8,3,13,4,0
358,Tomás Mendes,ESP,MF,Alavés,16,2004,0.1,0,0,0,0,0,0,0,,0,0,0,0,0,0,1,0
359,Brais Méndez,ESP,MF,Celta Vigo,24,1997,33.6,68,35,24,35,9,26,87,29.9,61,52,6,46,37,105,30,0
360,Édgar Méndez,ESP,FW|MF,Alavés,31,1990,17.9,25,14,11,10,4,11,34,32.4,23,16,0,16,4,29,17,0
361,Ferland Mendy,FRA,DF,Real Madrid,26,1995,19.3,24,14,11,10,3,8,14,57.1,6,8,2,6,18,42,27,3
362,Fran Mérida,ESP,MF,Espanyol,31,1990,3.0,7,3,5,2,0,4,10,40.0,6,1,0,1,6,13,1,0
363,Mikel Merino,ESP,MF,Real Sociedad,25,1996,32.1,71,38,21,40,10,26,67,38.8,41,50,10,40,21,92,56,2
364,Martín Merquelanz,ESP,FW|MF,Rayo Vallecano,26,1995,1.9,2,1,2,0,0,2,6,33.3,4,2,0,2,0,2,1,0
365,Matt Miazga,USA,DF,Alavés,26,1995,9.3,7,7,3,4,0,2,7,28.6,5,14,12,2,11,18,55,1
366,Miguel,ESP,FW|MF,Alavés,21,1999,9.2,7,3,1,5,1,2,15,13.3,13,6,0,6,1,8,7,0
367,Éder Militão,BRA,DF,Real Madrid,23,1998,33.7,50,32,30,12,8,20,39,51.3,19,42,20,22,52,102,107,3
368,Luis Milla,ESP,MF,Granada,26,1994,30.8,59,29,25,30,4,25,64,39.1,39,28,4,24,25,84,34,0
369,Pere Milla,ESP,MF|FW,Elche,28,1992,18.3,20,15,14,5,1,8,44,18.2,36,21,1,20,5,25,21,0
370,Santi Mina,ESP,FW,Celta Vigo,25,1995,26.3,27,17,8,15,4,5,32,15.6,27,28,2,26,6,33,22,0
371,Óscar Mingueza,ESP,DF,Barcelona,22,1999,9.9,25,11,12,11,2,16,23,69.6,7,5,0,5,9,34,22,1
372,Rafa Mir,ESP,FW,Sevilla,24,1997,20.1,4,3,1,1,2,0,11,0.0,11,4,3,1,0,4,17,0
373,Jorge Miramón,ESP,DF,Levante,32,1989,22.0,36,19,16,12,8,15,44,34.1,29,15,3,12,35,71,58,0
374,Juan Miranda,ESP,DF,Betis,21,2000,8.7,21,11,16,4,1,12,22,54.5,10,10,4,6,15,36,22,0
375,Stefan Mitrović,SRB,DF,Getafe,31,1990,29.6,16,8,12,4,0,8,13,61.5,5,28,18,10,22,38,114,1
376,Luka Modrić,CRO,MF,Real Madrid,35,1985,22.6,18,10,8,7,3,6,27,22.2,21,10,4,6,20,38,9,0
377,Johan Mojica,COL,DF,Elche,28,1992,31.7,46,25,34,7,5,23,31,74.2,8,22,3,19,25,71,61,3
378,Jorge Molina,ESP,FW,Granada,39,1982,21.8,4,2,2,1,1,2,18,11.1,16,13,2,11,6,10,11,0
379,Jon Moncayola,ESP,MF,Osasuna,23,1998,32.4,40,20,18,18,4,17,44,38.6,27,26,9,17,20,60,43,0
380,Monchu,ESP,MF,Granada,21,1999,7.4,15,6,5,9,1,5,10,50.0,5,8,3,5,4,19,4,0
381,Gonzalo Montiel,ARG,DF,Sevilla,24,1997,11.8,15,4,8,5,2,12,24,50.0,12,8,2,6,10,25,22,0
382,Ángel Montoro,ESP,MF,Granada,33,1988,14.8,26,13,16,7,3,17,27,63.0,10,11,1,10,11,37,29,1
383,Martín Montoya,ESP,DF,Betis,30,1991,5.8,20,12,11,7,2,15,26,57.7,11,6,0,6,11,31,20,0
384,Jon Morcillo,ESP,MF|FW,Athletic Club,22,1998,0.6,3,0,1,2,0,3,4,75.0,1,1,0,1,0,3,0,0
385,Alberto Moreno,ESP,MF|DF,Villarreal,29,1992,13.6,13,7,5,7,1,5,18,27.8,13,13,1,12,27,40,15,0
386,Álex Moreno,ESP,DF,Betis,28,1993,26.7,76,40,53,15,8,33,60,55.0,27,28,6,22,34,110,82,1
387,Gerard Moreno,ESP,FW,Villarreal,29,1992,13.2,5,2,2,2,1,1,7,14.3,6,6,1,5,6,11,14,0
388,Tete Morente,ESP,MF,Elche,24,1996,18.1,21,14,13,7,1,7,28,25.0,21,30,1,29,12,33,12,0
389,Ilaix Moriba,GUI,MF,Valencia,18,2003,9.1,26,18,10,13,3,14,35,40.0,21,15,0,15,12,38,14,0
390,Manu Morlanes,ESP,MF,Espanyol,22,1999,12.7,36,15,16,17,3,18,43,41.9,25,24,5,19,13,49,17,0
391,Loren Morón,ESP,FW|MF,Espanyol,27,1993,6.3,6,4,1,3,2,0,12,0.0,12,11,1,10,2,8,9,0
392,Loren Morón,ESP,FW,Betis,27,1993,0.0,1,1,1,0,0,1,1,100.0,0,0,0,0,0,1,0,0
393,Cristhian Mosquera,COL,DF,Valencia,17,2004,2.4,4,2,3,0,1,3,6,50.0,3,1,0,1,3,7,1,1
394,Toni Moya,ESP,MF,Alavés,23,1998,15.4,23,10,7,13,3,13,43,30.2,30,18,5,13,20,43,18,0
395,Iker Muniain,ESP,MF,Athletic Club,28,1992,30.9,32,10,8,19,5,12,40,30.0,28,20,1,19,17,49,8,1
396,Aihen Muñoz,ESP,DF,Real Sociedad,23,1997,14.9,28,17,14,13,1,18,29,62.1,11,11,1,10,17,45,34,0
397,Jeison Murillo,COL,DF,Celta Vigo,29,1992,12.4,15,10,13,2,0,9,13,69.2,4,11,8,3,17,32,37,0
398,Vedat Muriqi,KVX,FW,Mallorca,27,1994,16.0,6,3,1,3,2,1,7,14.3,6,12,0,12,6,12,29,0
399,Yunus Musah,USA,MF|FW,Valencia,18,2002,14.0,23,13,8,8,7,6,20,30.0,14,19,1,18,14,37,11,0
400,Shkodran Mustafi,GER,DF,Levante,29,1992,7.3,9,6,6,3,0,5,9,55.6,4,6,3,3,15,24,40,0
401,Mamadou N'Diaye,,MF,Alavés,24,1996,25.7,,20,,,,,,,,,,,36,,,
402,Nacho,ESP,DF,Real Madrid,31,1990,17.3,18,14,9,9,0,12,22,54.5,10,22,15,7,34,52,50,0
403,Roberto Navarro,ESP,MF|FW,Real Sociedad,19,2002,2.2,5,3,1,1,3,3,5,60.0,2,2,0,2,2,7,2,0
404,Ximo Navarro,ESP,DF,Alavés,31,1990,15.0,28,19,21,6,1,13,27,48.1,14,11,5,6,22,50,56,2
405,Jesús Navas,ESP,DF,Sevilla,35,1985,19.8,18,13,11,5,2,9,17,52.9,8,15,2,13,17,35,26,1
406,Álvaro Negredo,ESP,FW,Cádiz,35,1985,24.0,5,3,1,4,0,3,6,50.0,3,11,5,6,2,7,23,0
407,Neto,BRA,GK,Barcelona,32,1989,3.0,0,0,0,0,0,0,0,,0,0,0,0,0,0,2,1
408,Carlos Neva,ESP,DF,Granada,25,1996,23.4,31,19,24,7,0,16,28,57.1,12,27,9,18,32,63,81,0
409,Saúl Ñíguez,ESP,FW|MF,Atlético Madrid,26,1994,2.2,7,2,0,6,1,3,4,75.0,1,7,1,6,0,7,3,0
410,Fernando Niño,ESP,FW,Mallorca,20,2000,9.8,10,4,3,2,5,2,12,16.7,10,9,2,7,3,13,15,0
411,Peru Nolaskoain,ESP,DF,Athletic Club,22,1998,0.0,0,0,0,0,0,0,0,,0,0,0,0,0,0,0,0
412,Nolito,ESP,MF,Celta Vigo,34,1986,15.4,25,15,14,7,4,13,47,27.7,34,20,1,19,9,34,5,0
413,Randy Ntekja,FRA,FW|MF,Rayo Vallecano,23,1997,16.2,24,13,9,11,4,8,19,42.1,11,21,1,20,8,32,12,0
414,Unai Núñez,ESP,DF,Athletic Club,24,1997,6.9,4,4,2,2,0,3,6,50.0,3,9,8,1,8,12,26,2
415,Allan Nyom,CMR,DF,Getafe,33,1988,2.7,3,1,2,1,0,2,2,100.0,0,2,1,1,2,5,7,0
416,Jan Oblak,SVN,GK,Atlético Madrid,28,1993,38.0,0,0,0,0,0,0,0,,0,0,0,0,1,1,10,4
417,Lucas Ocampos,ARG,FW,Sevilla,27,1994,23.6,45,24,23,18,4,23,55,41.8,32,35,1,34,9,54,24,1
418,Lucas Olaza,URU,DF,Elche,27,1994,3.3,5,3,3,1,1,1,1,100.0,0,5,1,4,4,9,6,0
419,Oier Olazábal,ESP,GK,Espanyol,31,1989,1.5,0,0,0,0,0,0,0,,0,0,0,0,0,0,0,0
420,Brian Oliván,ESP,DF,Mallorca,27,1994,24.3,33,20,22,9,2,12,23,52.2,11,17,7,10,28,61,63,0
421,Mathías Olivera,URU,DF,Getafe,23,1997,31.1,79,47,39,34,6,40,69,58.0,29,45,4,41,55,134,67,1
422,Javier Ontiveros,ESP,FW|MF,Osasuna,23,1997,0.4,0,0,0,0,0,0,2,0.0,2,0,0,0,1,1,0,1
423,Pedro Ortiz,ESP,MF,Sevilla,20,2000,0.1,0,0,0,0,0,0,0,,0,0,0,0,0,0,1,0
424,Milutin Osmajić,MNE,FW|MF,Cádiz,22,1999,2.9,1,1,0,1,0,0,0,,0,0,0,0,1,2,3,0
425,Jesús Owono,EQG,GK,Alavés,20,2001,1.0,0,0,0,0,0,0,0,,0,0,0,0,0,0,1,0
426,Mikel Oyarzabal,ESP,FW|MF,Real Sociedad,24,1997,18.6,18,10,7,7,4,7,21,33.3,14,18,2,16,10,28,16,1
427,Fernando Pacheco,ESP,GK,Alavés,29,1992,33.9,2,1,2,0,0,2,2,100.0,0,0,0,0,0,2,18,1
428,Jon Pacheco,ESP,DF,Real Sociedad,20,2001,4.2,6,4,4,2,0,3,3,100.0,0,6,4,2,6,12,18,0
429,Helibelton Palacios,COL,DF,Elche,28,1993,21.5,69,38,56,10,3,37,55,67.3,18,21,8,13,18,87,61,0
430,Isaac Palazón Camacho,ESP,FW|MF,Rayo Vallecano,26,1994,25.4,42,28,20,19,3,18,59,30.5,41,31,3,28,13,55,22,0
431,Daniel Parejo,ESP,MF,Villarreal,32,1989,30.0,43,29,15,15,13,20,52,38.5,32,32,7,25,29,72,19,1
432,Raúl Parra,ESP,DF,Cádiz,21,1999,1.0,2,1,2,0,0,1,3,33.3,2,0,0,0,0,2,5,0
433,Javier Pastore,ARG,MF|FW,Elche,32,1989,5.8,7,3,3,2,2,3,12,25.0,9,5,1,4,4,11,2,0
434,Gabriel Paulista,BRA,DF,Valencia,30,1990,17.7,21,12,16,5,0,14,20,70.0,6,18,12,6,39,60,88,0
435,Alfonso Pedraza,ESP,DF,Villarreal,25,1996,18.9,34,16,17,12,5,10,28,35.7,18,12,3,9,31,65,32,0
436,Pedri,ESP,MF,Barcelona,18,2002,9.8,20,12,9,8,3,7,20,35.0,13,13,0,13,5,25,7,1
437,Adrià Pedrosa,ESP,DF,Espanyol,23,1998,30.2,58,30,38,14,6,26,57,45.6,31,25,7,18,25,83,92,2
438,Facundo Pellistri,URU,MF|FW,Alavés,19,2001,7.5,9,5,4,3,2,1,10,10.0,9,13,2,11,6,15,7,0
439,Rubén Peña,ESP,MF|FW,Villarreal,30,1991,1.5,2,0,1,1,0,2,6,33.3,4,1,0,1,5,7,2,0
440,Alberto Perea,ESP,MF,Cádiz,30,1990,8.6,19,9,7,9,3,6,20,30.0,14,15,1,14,9,28,4,0
441,Iñigo Pérez,ESP,MF,Osasuna,33,1988,3.8,3,2,2,1,0,2,4,50.0,2,1,0,1,0,3,3,0
442,Juan Pérez,ESP,GK,Osasuna,25,1996,2.0,0,0,0,0,0,0,1,0.0,1,0,0,0,0,0,1,1
443,Kike Pérez,ESP,MF|FW,Elche,24,1997,5.8,8,6,1,3,4,0,10,0.0,10,6,1,5,3,11,4,0
444,Lucas Pérez,ESP,FW,Elche,32,1988,14.1,4,1,2,1,1,3,10,30.0,7,2,0,2,3,7,4,0
445,Lucas Pérez,ESP,FW|MF,Cádiz,32,1988,11.8,3,3,2,1,0,0,10,0.0,10,3,1,2,0,3,1,0
446,Njegoš Petrović,SRB,MF,Granada,22,1999,10.2,24,11,4,19,1,8,14,57.1,6,16,4,12,9,33,11,0
447,Alex Petxa,ESP,DF|MF,Athletic Club,24,1997,4.6,12,9,4,7,1,4,8,50.0,4,8,2,6,4,16,6,0
448,Germán Pezzella,ARG,DF,Betis,30,1991,22.1,21,9,16,5,0,16,29,55.2,13,29,18,11,39,60,106,0
449,Pablo Piatti,ARG,MF|FW,Elche,32,1989,3.5,9,4,5,3,1,3,8,37.5,5,5,1,4,2,11,3,0
450,Cristiano Piccini,ITA,DF,Valencia,28,1992,3.6,14,8,9,5,0,5,7,71.4,2,3,2,1,1,15,11,0
451,Tomás Pina Isla,ESP,MF,Alavés,33,1987,16.0,28,16,13,11,4,14,29,48.3,15,12,3,9,22,50,23,0
452,Orbelín Pineda,MEX,MF|FW,Celta Vigo,25,1996,1.1,4,1,4,0,0,1,2,50.0,1,0,0,0,0,4,1,0
453,Yeremi Pino,ESP,MF|FW,Villarreal,18,2002,18.6,32,14,14,8,10,10,24,41.7,14,33,4,29,6,38,12,1
454,Gerard Piqué,ESP,DF,Barcelona,34,1987,23.2,22,12,18,4,0,11,14,78.6,3,19,16,3,34,56,86,1
455,Ezequiel Ponce,ARG,FW,Elche,24,1997,7.4,5,4,1,3,1,3,10,30.0,7,5,0,5,1,6,7,0
456,Pere Pons,ESP,MF,Alavés,28,1993,15.2,26,18,4,20,2,7,21,33.3,14,10,1,9,6,32,11,0
457,Portu,ESP,FW|MF,Real Sociedad,29,1992,17.7,16,7,2,6,8,3,19,15.8,16,21,3,18,7,23,8,0
458,Sergio Postigo,ESP,DF,Levante,32,1988,9.4,11,7,8,2,1,4,8,50.0,4,7,5,2,7,18,45,1
459,Darío Poveda,ESP,FW|MF,Getafe,24,1997,4.2,2,0,1,0,1,0,5,0.0,5,7,1,6,1,3,1,0
460,José Pozo,ESP,MF|DF,Rayo Vallecano,25,1996,0.8,2,2,0,2,0,2,3,66.7,1,1,0,1,0,2,1,0
461,Abdón Prats,ESP,FW,Mallorca,28,1992,7.1,2,2,1,0,1,1,5,20.0,4,5,0,5,1,3,6,0
462,Alejandro Primo,ESP,GK,Levante,17,2004,1.0,0,0,0,0,0,0,0,,0,0,0,0,0,0,0,0
463,Javi Puado,ESP,MF|FW,Espanyol,23,1998,24.9,24,14,18,5,1,12,37,32.4,25,18,2,16,11,35,24,0
464,Pubill,ESP,DF|MF,Levante,18,2003,5.7,12,6,10,2,0,4,8,50.0,4,7,2,5,4,16,8,2
465,Antonio Puertas,ESP,MF|FW,Granada,29,1992,25.1,34,20,18,12,4,17,44,38.6,27,33,3,30,11,45,36,0
466,Riqui Puig,ESP,MF,Barcelona,21,1999,5.4,6,3,2,4,0,2,14,14.3,12,5,0,5,3,9,0,0
467,Yacine Qasmi,MAR,FW,Rayo Vallecano,30,1991,0.0,0,0,0,0,0,0,0,,0,0,0,0,0,0,0,0
468,Quini,ESP,DF,Granada,31,1989,25.6,73,34,48,21,4,42,79,53.2,37,28,10,18,36,109,62,0
469,Dani Raba,ESP,MF|FW,Villarreal,25,1995,1.0,1,0,0,1,0,1,2,50.0,1,2,0,2,0,1,2,0
470,Dani Raba,ESP,MF|FW,Granada,25,1995,0.3,2,2,1,0,1,2,3,66.7,1,0,0,0,1,3,0,0
471,Uroš Račić,SRB,MF,Valencia,23,1998,13.4,32,18,9,19,4,12,33,36.4,21,16,6,10,16,48,21,0
472,Nemanja Radoja,SRB,MF,Levante,28,1993,13.5,25,8,9,13,3,8,20,40.0,12,16,9,7,22,47,16,2
473,Rafinha,BRA,MF,Real Sociedad,28,1993,11.7,43,27,17,20,6,16,28,57.1,12,21,2,19,12,55,4,0
474,Antonio Raillo,ESP,DF,Mallorca,29,1991,17.0,16,7,10,4,2,5,6,83.3,1,17,14,3,18,34,81,0
475,Ivan Rakitić,CRO,MF,Sevilla,33,1988,24.2,40,22,12,23,5,13,40,32.5,27,31,8,23,23,63,35,0
476,Jonás Ramalho,ESP,DF,Osasuna,28,1993,2.7,4,2,2,2,0,2,3,66.7,1,4,1,3,3,7,9,0
477,Sandro Ramírez,ESP,FW,Getafe,26,1995,16.2,7,3,1,3,3,1,12,8.3,11,14,3,11,2,9,3,0
478,Raúl,ESP,FW|DF,Betis,20,2000,0.0,0,0,0,0,0,0,0,,0,0,0,0,0,0,0,0
479,Lluís Recasens,ESP,DF,Espanyol,19,2002,0.5,2,0,2,0,0,1,1,100.0,0,0,0,0,2,4,2,0
480,Manolo Reina,ESP,GK,Mallorca,36,1985,21.0,0,0,0,0,0,0,0,,0,0,0,0,1,1,6,2
481,Karim Rekik,NED,DF,Sevilla,26,1994,12.2,11,8,4,6,1,2,9,22.2,7,11,6,5,9,20,19,0
482,Álex Remiro,ESP,GK,Real Sociedad,26,1995,35.0,0,0,0,0,0,0,0,,0,0,0,0,1,1,24,2
483,Nico Ribaudo,ESP,MF|FW,Espanyol,20,2001,12.4,15,6,9,5,1,11,34,32.4,23,14,2,12,7,22,3,0
484,Diego Rico,ESP,DF,Real Sociedad,28,1993,18.3,41,20,19,17,5,22,45,48.9,23,29,4,25,30,71,54,0
485,Sergio Rico,ESP,GK,Mallorca,27,1993,14.0,0,0,0,0,0,0,0,,0,0,0,0,0,0,5,2
486,Luis Rioja,ESP,MF|FW,Alavés,27,1993,34.6,28,15,11,10,7,14,58,24.1,44,22,1,21,25,53,20,0
487,Rober,ESP,DF,Levante,26,1995,22.3,36,20,27,7,2,23,39,59.0,16,25,15,10,30,66,90,1
488,Sergi Roberto,ESP,MF|DF,Barcelona,29,1992,4.4,5,1,2,3,0,3,5,60.0,2,2,0,2,4,9,6,0
489,Rubén Rochina,ESP,MF|FW,Granada,30,1991,8.3,21,13,7,8,6,8,28,28.6,20,11,1,10,6,27,5,1
490,Enzo Roco,CHI,DF,Elche,28,1992,28.4,36,20,24,11,1,15,24,62.5,9,38,27,11,28,64,110,3
491,Rodri,ESP,FW,Betis,21,2000,9.8,10,7,4,5,1,5,22,22.7,17,11,0,11,3,13,4,0
492,Kévin Rodrigues,POR,DF|FW,Rayo Vallecano,27,1994,4.8,15,11,8,7,0,6,10,60.0,4,10,1,9,7,22,6,0
493,Ángel Rodríguez,ESP,FW|MF,Mallorca,34,1987,17.2,15,9,6,7,2,4,21,19.0,17,15,1,14,3,18,13,0
494,Óscar Rodríguez Arnaiz,ESP,MF|FW,Getafe,23,1998,10.5,16,11,6,8,2,4,12,33.3,8,7,1,6,11,27,6,0
495,Óscar Rodríguez Arnaiz,ESP,FW|MF,Sevilla,23,1998,4.6,4,3,1,3,0,2,3,66.7,1,2,0,2,5,9,7,1
496,Dani Rodríguez,ESP,MF|FW,Mallorca,33,1988,31.5,53,31,20,24,9,15,46,32.6,31,28,3,25,20,73,27,0
497,Guido Rodríguez,ARG,MF,Betis,27,1994,28.1,97,53,46,45,6,54,98,55.1,44,55,12,43,31,128,56,0
498,Rodrygo,BRA,FW,Real Madrid,20,2001,16.9,18,14,7,4,7,3,18,16.7,15,21,0,21,11,29,3,0
499,Leonardo Román,ESP,GK,Mallorca,21,2000,2.0,0,0,0,0,0,0,0,,0,0,0,0,0,0,2,0
500,Iván Romero,ESP,FW,Sevilla,20,2001,2.0,2,2,0,2,0,0,0,,0,1,0,1,2,4,0,0
501,Unai Ropero,ESP,MF,Alavés,19,2001,0.1,0,0,0,0,0,0,0,,0,0,0,0,1,1,0,0
502,Rubén,ESP,DF,Espanyol,20,2001,1.7,6,1,4,2,0,4,7,57.1,3,0,0,0,2,8,4,0
503,Aitor Ruibal,ESP,FW|DF,Betis,25,1996,9.5,21,15,13,3,5,10,34,29.4,24,8,0,8,8,29,6,0
504,Isma Ruiz,ESP,MF,Granada,20,2001,3.1,3,1,3,0,0,1,9,11.1,8,5,2,3,3,6,2,0
505,Víctor Ruiz,ESP,DF,Betis,32,1989,15.8,11,9,7,2,2,6,9,66.7,3,18,13,5,29,40,71,1
506,Gerónimo Rulli,ARG,GK,Villarreal,29,1992,32.0,0,0,0,0,0,0,4,0.0,4,0,0,0,1,1,15,5
507,Franco Russo,ARG,DF,Mallorca,26,1994,16.3,19,10,10,9,0,13,31,41.9,18,14,9,5,27,46,73,1
508,Mathew Ryan,AUS,GK,Real Sociedad,29,1992,3.0,0,0,0,0,0,0,0,,0,0,0,0,0,0,2,0
509,Youssouf Sabaly,SEN,DF,Betis,28,1993,8.8,12,10,11,0,1,7,13,53.8,6,11,4,7,13,25,16,1
510,Salvi,ESP,MF|FW,Cádiz,30,1991,15.5,20,10,9,8,3,8,20,40.0,12,17,2,15,6,26,11,0
511,Fede San Emeterio,ESP,MF,Cádiz,24,1997,9.2,16,5,5,8,3,5,15,33.3,10,5,0,5,8,24,6,0
512,Oihan Sancet,ESP,FW,Athletic Club,21,2000,15.8,12,7,2,8,2,5,20,25.0,15,2,0,2,5,17,13,0
513,Antonio Sánchez,ESP,MF|FW,Mallorca,24,1997,18.0,53,24,29,17,7,19,49,38.8,30,32,2,30,32,85,32,1
514,Germán Sánchez,ESP,DF,Granada,34,1986,25.5,27,19,18,9,0,11,20,55.0,9,19,16,3,28,55,137,0
515,Manu Sánchez,ESP,DF,Osasuna,20,2000,25.1,72,34,41,22,9,43,79,54.4,36,28,3,25,18,90,43,0
516,Oier Sanjurjo,ESP,MF,Osasuna,35,1986,8.4,10,6,3,7,0,2,19,10.5,17,8,3,5,1,11,9,0
517,Jesús Santiago,ESP,MF,Valencia,17,2004,0.9,2,2,1,1,0,0,2,0.0,2,1,0,1,0,2,1,0
518,Sergio Santos,ESP,DF,Real Madrid,20,2001,0.1,0,0,0,0,0,0,0,,0,0,0,0,0,0,0,0
519,Alvaro Sanz,ESP,MF,Barcelona,20,2001,0.3,0,0,0,0,0,0,1,0.0,1,0,0,0,0,0,0,0
520,Marcelo Saracchi,URU,DF,Levante,23,1998,2.1,8,5,6,1,1,2,4,50.0,2,3,0,3,4,12,7,1
521,Joan Sastre Vanrell,ESP,DF,Mallorca,24,1997,2.9,6,3,5,0,1,3,4,75.0,1,3,0,3,2,8,10,0
522,Esteban Saveljich,MNE,DF,Rayo Vallecano,30,1991,18.9,18,11,11,7,0,9,15,60.0,6,20,12,8,16,34,69,0
523,Stefan Savić,MNE,DF,Atlético Madrid,30,1991,27.1,46,20,25,20,1,29,43,67.4,14,19,12,7,37,83,102,1
524,Valentino Scotta,ESP,DF,Sevilla,19,2001,0.0,0,0,0,0,0,0,0,,0,0,0,0,0,0,0,0
525,Aleksandar Sedlar,SRB,DF|MF,Mallorca,29,1991,4.5,5,3,4,1,0,3,5,60.0,2,4,4,0,5,10,19,0
526,Javier Serrano,ESP,MF,Atlético Madrid,18,2003,0.8,3,1,0,3,0,2,4,50.0,2,0,0,0,3,6,2,0
527,Nicolás Serrano,ESP,MF|FW,Athletic Club,18,2003,3.5,9,6,3,5,1,3,10,30.0,7,5,1,4,2,11,3,0
528,Salva Sevilla,ESP,MF,Mallorca,37,1984,16.7,18,12,8,8,2,6,17,35.3,11,12,6,6,14,32,11,0
529,David Silva,ESP,MF,Real Sociedad,35,1986,19.1,28,17,10,11,7,3,20,15.0,17,13,3,10,7,35,12,0
530,Jonathan Silva,ARG,DF|FW,Getafe,27,1994,2.5,10,8,4,4,2,7,12,58.3,5,4,0,4,3,13,7,0
531,Rui Silva,POR,GK,Betis,27,1994,21.8,1,0,1,0,0,1,2,50.0,1,0,0,0,1,2,11,1
532,Giuliano Simeone,ARG,MF,Atlético Madrid,18,2002,0.0,0,0,0,0,0,0,0,,0,0,0,0,0,0,0,0
533,Unai Simón,ESP,GK,Athletic Club,24,1997,34.0,0,0,0,0,0,0,0,,0,0,0,0,1,1,5,1
534,Antonio Sivera,ESP,GK,Alavés,24,1996,3.1,0,0,0,0,0,0,1,0.0,1,0,0,0,0,0,0,0
535,Rubén Sobrino,ESP,MF,Valencia,29,1992,0.2,1,1,1,0,0,1,1,100.0,0,1,0,1,2,3,0,0
536,Rubén Sobrino,ESP,FW|MF,Cádiz,29,1992,20.7,28,17,11,10,7,5,35,14.3,30,21,1,20,21,49,18,0
537,Alex Sola,ESP,DF|FW,Real Sociedad,22,1999,0.5,1,1,1,0,0,1,3,33.3,2,1,0,1,2,3,3,0
538,Augusto Solari,ARG,MF|DF,Celta Vigo,29,1992,7.9,24,12,9,12,3,12,32,37.5,20,14,4,10,7,31,10,1
539,Roberto Soldado,ESP,FW,Levante,36,1985,7.4,3,1,0,1,2,1,3,33.3,2,4,0,4,1,4,7,0
540,Carlos Soler,ESP,MF,Valencia,24,1997,27.5,29,19,10,15,4,11,37,29.7,26,19,4,15,14,43,28,0
541,Son,ESP,DF,Levante,27,1994,21.9,28,18,16,7,5,17,34,50.0,17,11,5,6,19,47,33,1
542,David Soria,ESP,GK,Getafe,28,1993,37.9,1,0,1,0,0,1,2,50.0,1,0,0,0,0,1,22,2
543,Alberto Soro,ESP,MF|FW,Granada,22,1999,6.4,12,10,3,6,3,1,7,14.3,6,21,2,19,3,15,4,0
544,Hugo Sotelo,ESP,FW,Celta Vigo,17,2003,0.0,0,0,0,0,0,0,0,,0,0,0,0,0,0,0,0
545,Damián Suárez,URU,DF,Getafe,33,1988,30.1,74,47,34,30,10,42,91,46.2,49,46,5,41,31,105,30,0
546,Denis Suárez,ESP,MF,Celta Vigo,27,1994,31.3,61,29,20,33,8,25,82,30.5,57,32,4,28,16,77,11,0
547,Luis Suárez,URU,FW,Atlético Madrid,34,1987,20.4,8,5,2,4,2,2,10,20.0,8,8,1,7,1,9,14,0
548,Mario Suárez,ESP,DF,Rayo Vallecano,34,1987,7.9,9,4,7,2,0,3,9,33.3,6,6,4,2,7,16,37,1
549,Suso,ESP,FW,Sevilla,27,1993,4.3,4,3,1,3,0,3,13,23.1,10,4,0,4,0,4,0,0
550,Mamadou Sylla,SEN,FW|MF,Alavés,27,1994,4.4,2,2,0,1,1,0,1,0.0,1,0,0,0,1,3,5,0
551,Mamadou Sylla,SEN,FW,Rayo Vallecano,27,1994,2.8,1,1,1,0,0,0,1,0.0,1,2,0,2,4,5,3,0
552,Alexander Sørloth,NOR,FW,Real Sociedad,25,1995,19.6,20,7,4,10,6,7,17,41.2,10,14,1,13,4,24,15,0
553,Tachi,ESP,DF,Alavés,23,1997,2.7,6,3,3,3,0,5,7,71.4,2,4,3,1,1,7,9,0
554,Renato Tapia,PER,MF,Celta Vigo,26,1995,15.7,50,31,15,31,4,20,50,40.0,30,21,5,16,28,78,43,0
555,Cristian Tello,ESP,FW,Betis,29,1991,9.1,17,11,6,7,4,13,31,41.9,18,9,0,9,10,27,6,0
556,Nahuel Tenaglia,ARG,DF,Alavés,25,1996,11.9,42,27,30,9,3,24,37,64.9,13,10,2,8,26,68,42,0
557,Marc Tenas,ESP,FW|MF,Alavés,20,2001,0.6,1,1,1,0,0,1,1,100.0,0,1,0,1,0,1,0,1
558,Marc-André ter Stegen,GER,GK,Barcelona,29,1992,35.0,0,0,0,0,0,0,1,0.0,1,0,0,0,1,1,13,5
559,David Timor,ESP,MF,Getafe,31,1989,3.8,1,1,1,0,0,0,3,0.0,3,3,2,1,1,2,4,1
560,Mircea Ţîrlea,ROU,DF,Alavés,21,2000,0.2,0,0,0,0,0,0,0,,0,0,0,0,0,0,1,0
561,Raúl de Tomás,ESP,FW,Espanyol,26,1994,32.4,15,11,6,7,2,6,17,35.3,11,12,3,9,6,21,42,1
562,Raúl Torrente,ESP,DF,Granada,19,2001,14.2,31,21,18,11,2,16,29,55.2,13,14,9,5,12,43,69,0
563,Ferrán Torres,ESP,FW,Barcelona,21,2000,15.7,10,5,3,4,3,3,7,42.9,4,12,3,9,6,16,7,0
564,Óliver Torres,ESP,MF|FW,Sevilla,26,1994,11.2,22,12,8,7,7,8,25,32.0,17,10,1,9,6,28,4,0
565,Pau Torres,ESP,DF,Villarreal,24,1997,31.7,32,19,23,7,2,18,25,72.0,7,32,23,9,19,51,105,2
566,Roberto Torres,ESP,MF|FW,Osasuna,32,1989,9.0,7,4,3,1,3,3,15,20.0,12,8,0,8,8,15,4,0
567,Lucas Torró,ESP,MF,Osasuna,27,1994,30.3,71,40,25,38,8,29,57,50.9,28,32,11,21,47,118,55,0
568,Adama Traoré,ESP,FW,Barcelona,25,1996,4.2,4,2,0,3,1,3,5,60.0,2,2,0,2,4,8,3,1
569,Óscar Trejo,ARG,MF,Rayo Vallecano,33,1988,22.3,42,24,14,18,10,15,50,30.0,35,26,1,25,13,55,11,0
570,Manu Trigueros,ESP,MF|FW,Villarreal,29,1991,24.2,45,25,16,18,11,23,66,34.8,43,19,3,16,13,58,17,0
571,Kieran Trippier,ENG,DF|FW,Atlético Madrid,30,1990,10.8,22,12,12,5,5,12,21,57.1,9,12,1,11,10,32,11,0
572,Beñat Turrientes,ESP,MF,Real Sociedad,19,2002,2.3,0,0,0,0,0,0,4,0.0,4,1,0,1,2,2,2,0
573,Samuel Umtiti,FRA,DF,Barcelona,27,1993,1.0,2,2,2,0,0,1,2,50.0,1,1,1,0,0,2,4,0
574,Enes Ünal,TUR,FW,Getafe,24,1997,31.1,37,22,2,18,17,5,42,11.9,37,25,5,20,5,42,36,0
575,Myrto Uzuni,ALB,FW|MF,Granada,26,1995,9.5,7,4,6,1,0,0,2,0.0,2,13,1,12,10,17,7,0
576,Álvaro Vadillo,ESP,DF|MF,Espanyol,26,1994,0.1,1,1,1,0,0,1,2,50.0,1,0,0,0,0,1,1,0
577,Óscar Valentín,ESP,MF,Rayo Vallecano,26,1994,28.5,102,53,46,51,5,44,105,41.9,61,56,10,46,39,141,43,0
578,Germán Valera,ESP,FW,Real Sociedad,19,2002,0.6,3,2,3,0,0,1,1,100.0,0,0,0,0,0,3,1,0
579,Martin Valjent,SVK,DF,Mallorca,25,1995,35.3,31,19,18,12,1,13,24,54.2,11,34,26,8,31,62,173,1
580,Jesús Vallejo,ESP,DF,Real Madrid,24,1997,3.8,7,5,7,0,0,5,6,83.3,1,9,8,1,6,13,16,0
581,Manu Vallejo,ESP,MF|FW,Alavés,24,1997,4.1,8,2,1,4,3,4,13,30.8,9,7,0,7,0,8,4,0
582,Manu Vallejo,ESP,FW|MF,Valencia,24,1997,1.1,2,1,1,1,0,0,1,0.0,1,0,0,0,0,2,1,0
583,Federico Valverde,URU,MF,Real Madrid,23,1998,20.4,36,16,11,16,9,12,31,38.7,19,23,5,18,24,60,12,0
584,José Luis García Vayá,ESP,MF,Levante,22,1998,22.4,46,27,10,31,5,16,41,39.0,25,24,5,19,38,84,30,0
585,Jesus Vazquez,ESP,DF,Valencia,18,2003,9.0,24,13,10,8,6,10,22,45.5,12,16,3,13,9,33,19,0
586,Kevin Vázquez,ESP,DF,Celta Vigo,28,1993,14.8,34,24,12,13,9,14,28,50.0,14,20,7,13,36,70,34,0
587,Lucas Vázquez,ESP,DF,Real Madrid,30,1991,20.4,43,22,24,9,10,17,35,48.6,18,25,7,18,20,63,41,1
588,Gabriel Veiga,ESP,MF,Celta Vigo,19,2002,1.2,5,4,0,4,1,3,12,25.0,9,2,0,2,4,9,1,0
589,Unai Vencedor Paris,ESP,MF,Athletic Club,20,2000,26.5,26,11,11,9,6,8,42,19.0,34,31,13,18,19,45,22,0
590,Gonzalo Verdú,ESP,DF,Elche,32,1988,15.5,19,9,15,4,0,8,16,50.0,8,20,14,6,13,32,59,1
591,Mikel Vesga,ESP,MF,Athletic Club,28,1993,15.1,27,14,7,18,2,11,31,35.5,20,16,5,11,20,47,34,2
592,Rúben Vezo,POR,DF,Levante,27,1994,26.9,41,29,28,12,1,26,41,63.4,15,41,25,16,36,77,105,1
593,Aleix Vidal,ESP,DF|MF,Espanyol,31,1989,21.1,31,25,17,9,5,19,39,48.7,20,19,6,13,25,56,35,2
594,Nacho Vidal,ESP,DF,Osasuna,26,1995,32.2,83,47,49,25,9,39,77,50.6,38,32,14,18,58,141,79,0
595,Dídac Vilà,ESP,DF|MF,Espanyol,32,1989,2.3,7,5,2,5,0,4,9,44.4,5,2,1,1,3,10,8,0
596,Tonny Vilhena,NED,MF|FW,Espanyol,26,1995,10.3,16,6,7,8,1,7,21,33.3,14,10,2,8,8,24,17,0
597,Daniel Villahermosa,ESP,MF,Espanyol,20,2001,0.3,0,0,0,0,0,0,0,,0,0,0,0,0,0,1,0
598,Asier Villalibre,ESP,FW,Athletic Club,23,1997,6.1,4,3,2,1,1,1,2,50.0,1,3,1,2,1,5,7,0
599,Gonzalo Villar,ESP,MF,Getafe,23,1998,3.3,5,3,4,1,0,2,5,40.0,3,4,1,3,1,6,1,0
600,Vitolo,ESP,MF,Getafe,31,1989,2.5,3,2,1,1,1,2,5,40.0,3,3,0,3,1,4,1,0
601,Daniel Vivian,ESP,DF,Athletic Club,22,1999,22.1,32,21,24,7,1,17,24,70.8,7,20,15,5,26,58,107,1
602,Šime Vrsaljko,CRO,DF,Atlético Madrid,29,1992,10.2,27,17,14,12,1,12,20,60.0,8,10,1,9,12,39,30,0
603,Nikola Vukčević,MNE,MF,Levante,29,1991,1.3,3,2,2,1,0,0,1,0.0,1,2,0,2,2,5,1,0
604,Daniel Wass,DEN,DF|FW,Atlético Madrid,32,1989,0.5,0,0,0,0,0,0,0,,0,0,0,0,0,0,3,0
605,Daniel Wass,DEN,MF,Valencia,32,1989,17.6,23,13,6,14,3,8,31,25.8,23,13,2,11,13,36,19,0
606,Iñaki Williams,GHA,FW,Athletic Club,27,1994,30.9,14,5,1,6,7,5,17,29.4,12,18,3,15,3,17,20,0
607,Nico Williams,ESP,MF,Athletic Club,19,2002,14.9,20,10,6,11,3,10,31,32.3,21,18,2,16,5,25,9,0
608,Okay Yokuşlu,TUR,DF|MF,Getafe,27,1994,5.2,9,8,6,2,1,5,5,100.0,0,7,5,2,5,14,17,0
609,Okay Yokuşlu,TUR,DF|MF,Celta Vigo,27,1994,1.6,4,1,2,1,1,2,3,66.7,1,2,1,1,2,6,6,0
610,Joseba Zaldúa,ESP,DF,Real Sociedad,29,1992,13.0,31,22,20,8,3,16,22,72.7,6,14,4,10,13,44,35,0
611,Oier Zarraga,ESP,MF,Athletic Club,22,1999,13.0,13,5,4,7,2,3,28,10.7,25,17,10,7,19,32,10,0
612,Luca Zidane,FRA,GK,Rayo Vallecano,23,1998,7.2,0,0,0,0,0,0,1,0.0,1,0,0,0,0,0,1,1
613,Igor Zubeldia,ESP,DF,Real Sociedad,24,1997,18.3,20,10,12,8,0,12,18,66.7,6,16,6,10,27,47,53,0
614,Martín Zubimendi,ESP,MF,Real Sociedad,22,1999,28.8,52,25,19,30,3,22,44,50.0,22,30,13,17,49,101,48,1
615,Blanco,,MF,Real Madrid,21,2000,0.3,,0,,,,,,,,,,,1,,,
616,Hugo Guillamón,,DF|MF,Valencia,21,2000,26.2,,26,,,,,,,,,,,29,,,
