Rk,Player,Nation,Pos,Squad,Age,Born,90s,Tackles Tkl,Tackles TklW,Tackles Def 3rd,Tackles Mid 3rd,Tackles Att 3rd,Challenges Tkl,Challenges Att,Challenges Tkl%,Challenges Lost,Blocks Blocks,Blocks Sh,Blocks Pass,Int,Tkl+Int,Clr,Err
1,Issah Abbas,GHA,FW,Mainz 05,19,1998,0.1,0,0,0,0,0,0,0,,0,0,0,0,0,0,0,0
2,David Abraham,ARG,DF,Eint Frankfurt,32,1986,15.8,22,14,13,8,1,11,25,44.0,14,23,12,11,24,46,64,0
3,Amir Abrashi,ALB,MF,Freiburg,28,1990,8.8,20,11,7,10,3,6,19,31.6,13,11,3,8,14,34,15,0
4,Tyler Adams,USA,MF,RB Leipzig,19,1999,8.0,29,17,12,16,1,11,26,42.3,15,17,1,16,16,45,8,0
5,Antonis Aidonis,GER,DF,Stuttgart,17,2001,0.9,3,1,1,1,1,1,4,25.0,3,1,0,1,2,5,2,0
6,Manuel Akanji,SUI,DF,Dortmund,23,1995,24.5,29,19,14,13,2,14,25,56.0,11,22,13,9,27,56,92,2
7,Chadrac Akolo,COD,MF|FW,Stuttgart,23,1995,5.8,9,6,2,7,0,1,3,33.3,2,7,0,7,4,13,1,0
8,Kevin Akpoguma,NGA,DF,Hoffenheim,23,1995,5.5,23,15,13,10,0,11,21,52.4,10,18,5,13,12,35,20,2
9,Kevin Akpoguma,NGA,DF,Hannover 96,23,1995,3.5,10,6,5,5,0,6,7,85.7,1,7,2,5,10,20,7,2
10,David Alaba,AUT,DF,Bayern Munich,26,1992,28.1,34,21,13,13,8,17,26,65.4,9,24,3,21,31,65,40,0
11,Lucas Alario,ARG,FW|MF,Leverkusen,25,1992,14.1,15,8,5,6,4,4,14,28.6,10,9,0,9,1,16,16,0
12,Miiko Albornoz,CHI,DF|MF,Hannover 96,27,1990,18.4,46,26,31,10,5,21,45,46.7,24,23,3,20,16,62,37,1
13,Paco Alcácer,ESP,FW,Dortmund,24,1993,13.5,3,1,2,0,1,0,6,0.0,6,5,0,5,6,9,7,0
14,Thiago Alcántara,ESP,MF,Bayern Munich,27,1991,26.8,87,65,31,44,12,25,48,52.1,23,23,4,19,44,131,17,1
15,Allan,BRA,MF,Eint Frankfurt,21,1997,2.0,4,4,2,2,0,0,4,0.0,4,4,2,2,0,4,1,0
16,Alfons Amade,GER,MF,Hoffenheim,18,1999,0.1,1,1,0,1,0,1,2,50.0,1,0,0,0,1,2,0,0
17,Nadiem Amiri,GER,MF,Hoffenheim,21,1996,8.4,14,9,8,4,2,3,13,23.1,10,11,0,11,7,21,4,0
18,Waldemar Anton,GER,DF,Hannover 96,22,1996,34.0,49,32,33,14,2,22,50,44.0,28,56,33,23,69,118,169,3
19,Dennis Aogo,GER,MF,Stuttgart,31,1987,11.4,15,10,6,7,2,6,15,40.0,9,8,1,7,9,24,19,0
20,Charles Aránguiz,CHI,MF,Leverkusen,29,1989,21.0,48,30,21,22,5,21,66,31.8,45,31,2,29,25,73,27,1
21,Maximilian Arnold,GER,MF,Wolfsburg,24,1994,31.9,52,30,21,27,4,21,61,34.4,40,31,10,21,35,87,48,1
22,Takuma Asano,JPN,MF|FW,Hannover 96,23,1994,7.8,5,3,1,1,3,1,6,16.7,5,9,0,9,2,7,2,0
23,Santiago Ascacíbar,ARG,MF,Stuttgart,21,1997,27.0,78,50,43,29,6,34,74,45.9,40,48,10,38,43,121,34,1
24,Simon Asta,GER,DF,Augsburg,17,2001,1.0,6,3,4,2,0,2,2,100.0,0,2,1,1,3,9,1,0
25,Jean-Kévin Augustin,FRA,FW,RB Leipzig,21,1997,5.1,2,0,0,0,2,0,1,0.0,1,6,0,6,3,5,0,0
26,Ludwig Augustinsson,SWE,DF,Werder Bremen,24,1994,33.6,53,31,25,22,6,23,39,59.0,16,37,11,26,38,91,86,1
27,Kaan Ayhan,TUR,DF,Düsseldorf,23,1994,27.2,53,29,38,15,0,23,47,48.9,24,34,16,18,59,112,118,3
28,Florian Baak,GER,MF,Hertha BSC,19,1999,0.0,0,0,0,0,0,0,0,,0,0,0,0,0,0,0,0
29,Holger Badstuber,GER,DF,Stuttgart,29,1989,5.8,12,4,8,4,0,7,8,87.5,1,6,2,4,9,21,21,1
30,Daniel Baier,GER,MF,Augsburg,34,1984,31.3,62,39,21,37,4,24,66,36.4,42,27,8,19,60,122,48,2
31,Leon Bailey,JAM,FW,Leverkusen,20,1997,21.3,15,11,9,2,4,6,20,30.0,14,20,0,20,14,29,11,0
32,Marvin Bakalorz,GER,MF,Hannover 96,28,1989,16.3,18,11,7,9,2,6,36,16.7,30,29,4,25,28,46,47,0
33,Ridle Baku,GER,MF,Mainz 05,20,1998,10.4,18,9,6,9,3,2,7,28.6,5,13,1,12,8,26,9,0
34,Philipp Bargfrede,GER,MF|DF,Werder Bremen,29,1989,12.0,23,15,9,12,2,10,28,35.7,18,35,11,24,34,57,45,1
35,Aymen Barkok,MAR,MF,Düsseldorf,20,1998,5.7,13,6,4,9,0,4,19,21.1,15,8,1,7,4,17,3,0
36,Leandro Barreiro Martins,LUX,MF,Mainz 05,18,2000,1.0,4,4,2,0,2,1,2,50.0,1,0,0,0,2,6,1,0
37,Fin Bartels,GER,MF|FW,Werder Bremen,31,1987,0.3,0,0,0,0,0,0,1,0.0,1,0,0,0,1,1,0,0
38,Robert Bauer,GER,DF,Nürnberg,23,1995,19.1,48,29,32,13,3,20,39,51.3,19,19,5,14,28,76,80,0
39,Oliver Baumann,GER,GK,Hoffenheim,28,1990,33.0,0,0,0,0,0,0,0,,0,0,0,0,2,2,11,5
40,Timo Baumgartl,GER,DF,Stuttgart,22,1996,18.0,33,23,21,12,0,11,19,57.9,8,31,22,9,26,59,100,0
41,Julian Baumgartlinger,AUT,MF,Leverkusen,30,1988,17.3,52,30,24,20,8,20,45,44.4,25,18,6,12,26,78,21,1
42,Christoph Baumgartner,AUT,MF,Hoffenheim,18,1999,0.9,1,0,0,0,1,1,3,33.3,2,2,0,2,0,1,0,0
43,Noah Joel Sarenren Bazee,NGA,FW|MF,Hannover 96,21,1996,1.7,0,0,0,0,0,0,0,,0,1,0,1,0,0,3,0
44,Ihlas Bebou,TOG,MF|FW,Hannover 96,24,1994,11.8,15,9,4,10,1,4,9,44.4,5,18,2,16,9,24,9,0
45,Uffe Bech,DEN,FW,Hannover 96,25,1993,0.2,0,0,0,0,0,0,1,0.0,1,0,0,0,0,0,0,0
46,Andreas Beck,GER,DF,Stuttgart,31,1987,19.7,35,19,17,17,1,11,27,40.7,16,32,6,26,22,57,54,0
47,Hanno Behrens,GER,MF,Nürnberg,28,1990,29.3,46,26,29,17,0,21,47,44.7,26,43,13,30,33,79,49,0
48,Ishak Belfodil,ALG,FW|MF,Hoffenheim,26,1992,20.7,13,10,5,6,2,4,16,25.0,12,6,0,6,3,16,14,0
49,Stefan Bell,GER,DF,Mainz 05,26,1991,25.0,31,20,18,13,0,15,34,44.1,19,31,11,20,54,85,122,1
50,Karim Bellarabi,GER,FW,Leverkusen,28,1990,11.7,13,6,7,4,2,3,19,15.8,16,13,0,13,10,23,8,0
51,Lars Bender,GER,MF|DF,Leverkusen,29,1989,15.1,43,29,20,20,3,18,35,51.4,17,26,4,22,21,64,26,0
52,Sven Bender,GER,DF,Leverkusen,29,1989,22.1,40,25,25,15,0,18,30,60.0,12,31,14,17,52,92,98,0
53,László Bénes,SVK,MF|FW,M'Gladbach,20,1997,0.3,3,1,3,0,0,3,3,100.0,0,1,0,1,0,3,0,0
54,Nabil Bentaleb,ALG,MF,Schalke 04,23,1994,19.9,32,17,8,21,3,4,18,22.2,14,28,8,20,35,67,19,0
55,Jordan Beyer,GER,DF,M'Gladbach,18,2000,8.0,32,18,21,10,1,17,24,70.8,7,12,6,6,11,43,32,0
56,Ermin Bičakčić,BIH,DF,Hoffenheim,28,1990,19.9,32,19,18,11,3,13,22,59.1,9,36,15,21,56,88,79,1
57,Leonardo Bittencourt,GER,MF,Hoffenheim,24,1993,11.9,37,26,9,22,6,8,32,25.0,24,22,1,21,13,50,7,0
58,Pablo de Blasis,ARG,FW,Mainz 05,30,1988,1.0,2,0,0,1,1,2,3,66.7,1,0,0,0,1,3,0,0
59,Danny Blum,GER,MF,Eint Frankfurt,27,1991,0.0,0,0,0,0,0,0,0,,0,0,0,0,0,0,5,0
60,Jérôme Boateng,GER,DF,Bayern Munich,29,1988,18.8,21,15,12,9,0,10,22,45.5,12,8,3,5,25,46,49,0
61,Adam Bodzek,GER,MF|DF,Düsseldorf,32,1985,17.7,44,27,27,16,1,17,43,39.5,26,15,6,9,26,70,39,0
62,Jean-Paul Boëtius,NED,MF,Mainz 05,24,1994,23.6,51,32,21,25,5,16,44,36.4,28,59,2,57,37,88,13,0
63,Robin Bormuth,GER,DF,Düsseldorf,22,1995,6.8,7,4,7,0,0,5,10,50.0,5,6,4,2,10,17,49,1
64,Nassim Boujellab,MAR,MF,Schalke 04,19,1999,4.2,10,4,3,6,1,3,11,27.3,8,6,0,6,2,12,3,0
65,Julian Brandt,GER,MF|FW,Leverkusen,22,1996,29.6,27,16,13,10,4,7,43,16.3,36,27,1,26,17,44,12,1
66,Fabian Bredlow,GER,GK,Nürnberg,23,1995,12.5,1,1,1,0,0,1,1,100.0,0,0,0,0,1,2,3,4
67,Josip Brekalo,CRO,FW|MF,Wolfsburg,20,1998,15.7,15,7,7,6,2,5,18,27.8,13,15,1,14,12,27,9,1
68,Joshua Brenet,NED,DF,Hoffenheim,24,1994,10.1,20,13,12,5,3,7,13,53.8,6,16,1,15,8,28,19,0
69,John Brooks,USA,DF,Wolfsburg,25,1993,29.0,29,15,18,9,2,13,27,48.1,14,28,13,15,37,66,135,3
70,Daniel Brosinski,GER,DF,Mainz 05,30,1988,24.5,27,16,16,10,1,18,33,54.5,15,30,9,21,26,53,58,0
71,Bruma,POR,MF,RB Leipzig,23,1994,6.1,5,2,3,1,1,1,5,20.0,4,4,0,4,4,9,2,0
72,Jeffrey Bruma,NED,DF,Schalke 04,26,1991,6.9,12,11,8,4,0,6,12,50.0,6,8,2,6,4,16,35,0
73,Jacob Bruun Larsen,DEN,FW,Dortmund,19,1998,14.1,15,9,8,2,5,7,17,41.2,10,15,1,14,13,28,12,0
74,Niko Bungert,GER,DF,Mainz 05,31,1986,3.2,7,5,5,2,0,5,5,100.0,0,7,6,1,4,11,16,0
75,Guido Burgstaller,AUT,FW,Schalke 04,29,1989,17.0,11,9,2,5,4,3,8,37.5,5,5,0,5,2,13,10,0
76,Jonathan Burkardt,GER,FW|MF,Mainz 05,18,2000,2.9,4,4,2,1,1,1,2,50.0,1,2,0,2,3,7,5,0
77,Roman Bürki,SUI,GK,Dortmund,27,1990,32.0,1,0,1,0,0,1,2,50.0,1,1,0,1,2,3,8,4
78,Gaëtan Bussmann,FRA,DF,Mainz 05,27,1991,1.0,2,1,2,0,0,2,5,40.0,3,0,0,0,1,3,2,0
79,Jakub Błaszczykowski,POL,MF,Wolfsburg,32,1985,0.1,0,0,0,0,0,0,0,,0,0,0,0,0,0,0,0
80,Caiuby,BRA,MF|FW,Augsburg,30,1988,11.2,12,10,5,6,1,3,11,27.3,8,16,1,15,5,17,10,0
81,Daniel Caligiuri,ITA,DF|FW,Schalke 04,30,1988,30.6,93,52,55,29,9,44,103,42.7,59,66,10,56,50,143,72,1
82,Jan-Ingwer Callsen-Bracker,GER,DF,Augsburg,33,1984,0.1,0,0,0,0,0,0,0,,0,0,0,0,0,0,0,0
83,Ignacio Camacho,ESP,MF,Wolfsburg,28,1990,6.0,15,9,9,6,0,3,7,42.9,4,7,2,5,18,33,12,0
84,Jonas Carls,GER,FW,Schalke 04,21,1997,1.0,5,2,4,0,1,5,5,100.0,0,0,0,0,1,6,0,0
85,Koen Casteels,BEL,GK,Wolfsburg,26,1992,25.5,1,0,1,0,0,1,2,50.0,1,1,0,1,0,1,11,1
86,Gonzalo Castro,GER,MF,Stuttgart,31,1987,18.8,50,28,21,25,4,19,43,44.2,24,23,5,18,29,79,22,1
87,Timothy Chandler,USA,DF,Eint Frankfurt,28,1990,0.2,0,0,0,0,0,0,0,,0,0,0,0,0,0,0,0
88,Per Ciljan Skjelbred,NOR,MF,Hertha BSC,31,1987,11.1,26,18,13,12,1,5,22,22.7,17,10,1,9,20,46,14,0
89,Kingsley Coman,FRA,FW|MF,Bayern Munich,22,1996,15.3,11,6,4,4,3,6,19,31.6,13,20,0,20,5,16,3,0
90,Sergio Córdova,VEN,FW,Augsburg,20,1997,5.9,9,5,3,4,2,2,6,33.3,4,0,0,0,3,12,5,0
91,Danny da Costa,GER,DF|FW,Eint Frankfurt,25,1993,33.7,61,35,29,25,7,18,42,42.9,24,51,9,42,32,93,67,0
92,Mickaël Cuisance,FRA,MF,M'Gladbach,18,1999,3.1,11,6,6,3,2,3,8,37.5,5,3,0,3,5,16,4,0
93,Matheus Cunha,BRA,FW|MF,RB Leipzig,19,1999,9.5,10,6,3,5,2,3,13,23.1,10,13,1,12,4,14,8,0
94,Christoph Daferner,GER,FW,Freiburg,20,1998,0.3,1,0,1,0,0,0,0,,0,0,0,0,1,2,0,0
95,Mahmoud Dahoud,GER,MF,Dortmund,22,1996,7.7,16,10,4,10,2,3,15,20.0,12,10,0,10,17,33,8,0
96,Leon Dajaku,GER,DF|MF,Stuttgart,17,2001,0.3,2,1,0,1,1,0,0,,0,1,0,1,0,2,0,0
97,Kevin Danso,AUT,DF,Augsburg,19,1998,13.9,25,14,21,3,1,11,14,78.6,3,25,17,8,19,44,72,0
98,Palkó Dárdai,HUN,FW|MF,Hertha BSC,19,1999,1.3,1,1,1,0,0,0,0,,0,1,0,1,0,1,0,0
99,Vladimír Darida,CZE,MF,Hertha BSC,27,1990,4.2,8,5,3,4,1,2,3,66.7,1,5,0,5,8,16,5,0
100,Alphonso Davies,CAN,MF|FW,Bayern Munich,17,2000,0.9,1,1,1,0,0,0,0,,0,2,0,2,2,3,1,0
101,Thomas Delaney,DEN,MF,Dortmund,26,1991,25.4,69,54,28,39,2,19,30,63.3,11,30,9,21,58,127,43,0
102,Kerem Demirbay,GER,MF,Hoffenheim,25,1993,22.4,57,35,20,27,10,11,51,21.6,40,34,10,24,22,79,25,0
103,Diego Demme,GER,MF,RB Leipzig,26,1991,22.8,75,47,24,43,8,33,67,49.3,34,36,3,33,26,101,15,0
104,Franco Di Santo,ARG,MF|FW,Schalke 04,29,1989,2.7,2,1,0,2,0,1,4,25.0,3,3,1,2,1,3,3,0
105,Abdou Diallo,SEN,DF,Dortmund,22,1996,26.4,36,20,20,13,3,11,15,73.3,4,28,15,13,26,62,91,1
106,Daniel Didavi,GER,MF|FW,Stuttgart,28,1990,10.6,21,15,8,10,3,7,20,35.0,13,11,1,10,4,25,5,0
107,Tim Dierßen,GER,MF,Hannover 96,22,1996,0.2,0,0,0,0,0,0,0,,0,1,0,1,0,0,0,0
108,Javairô Dilrosun,NED,FW|MF,Hertha BSC,20,1998,10.0,14,10,7,5,2,3,7,42.9,4,18,2,16,7,21,9,0
109,Giulio Donati,ITA,DF,Mainz 05,28,1990,6.9,9,7,6,3,0,8,10,80.0,2,5,3,2,16,25,24,0
110,Ji Dong-won,KOR,MF|FW,Augsburg,27,1991,9.9,10,6,5,3,2,6,16,37.5,10,13,2,11,8,18,10,0
111,Anastasios Donis,GRE,FW|MF,Stuttgart,21,1996,10.7,15,13,8,4,3,3,11,27.3,8,7,0,7,4,19,0,0
112,Aleksandar Dragović,AUT,DF,Leverkusen,27,1991,14.8,18,12,14,4,0,9,14,64.3,5,15,8,7,25,43,66,0
113,Josip Drmić,SUI,FW,M'Gladbach,25,1992,2.5,2,0,0,2,0,1,2,50.0,1,1,0,1,1,3,0,0
114,Jaroslav Drobný,CZE,GK,Düsseldorf,38,1979,2.0,0,0,0,0,0,0,0,,0,0,0,0,0,0,1,0
115,Marvin Ducksch,GER,FW,Düsseldorf,24,1994,9.1,3,1,0,2,1,1,5,20.0,4,4,0,4,4,7,11,0
116,Ondrej Duda,SVK,MF,Hertha BSC,23,1994,28.5,54,33,13,35,6,15,55,27.3,40,36,4,32,15,69,17,1
117,Johannes Eggestein,GER,FW|MF,Werder Bremen,20,1998,12.4,13,9,7,4,2,5,19,26.3,14,13,0,13,4,17,7,0
118,Maximilian Eggestein,GER,MF,Werder Bremen,21,1996,33.9,68,42,29,34,5,24,54,44.4,30,49,10,39,30,98,69,0
119,Josip Elez,CRO,DF,Hannover 96,24,1994,7.2,8,3,5,3,0,2,11,18.2,9,13,4,9,6,14,27,0
120,Nico Elvedi,SUI,DF,M'Gladbach,21,1996,29.1,41,19,34,7,0,23,33,69.7,10,30,13,17,47,88,135,6
121,Breel Embolo,SUI,FW,Schalke 04,21,1997,14.9,22,17,4,13,5,1,9,11.1,8,11,0,11,4,26,6,0
122,Patrick Erras,GER,MF,Nürnberg,23,1995,13.6,15,10,7,7,1,7,19,36.8,12,24,13,11,23,38,45,0
123,Michael Esser,GER,GK,Hannover 96,30,1987,32.0,3,2,3,0,0,2,5,40.0,3,1,0,1,1,4,15,0
124,Alexander Esswein,GER,MF|FW,Stuttgart,28,1990,13.9,17,11,6,4,7,6,21,28.6,15,17,0,17,12,29,16,0
125,Ewerton,BRA,DF,Nürnberg,29,1989,14.9,24,20,21,3,0,8,14,57.1,6,23,16,7,25,49,108,1
126,Marco Fabián,MEX,FW,Eint Frankfurt,29,1989,0.7,3,2,2,1,0,1,1,100.0,0,0,0,0,3,6,0,0
127,Ralf Fährmann,GER,GK,Schalke 04,29,1988,16.3,0,0,0,0,0,0,0,,0,0,0,0,2,2,10,4
128,Simon Falette,GUI,DF,Eint Frankfurt,26,1992,6.7,9,6,7,1,1,2,6,33.3,4,11,5,6,14,23,32,0
129,Felipe,BRA,DF,Hannover 96,31,1987,12.2,23,15,21,2,0,9,17,52.9,8,17,9,8,35,58,71,0
130,Ohis Felix Uduokhai,GER,DF,Wolfsburg,20,1997,2.7,13,7,7,5,1,9,10,90.0,1,6,2,4,6,19,11,1
131,Gelson Fernandes,SUI,MF,Eint Frankfurt,31,1986,24.7,74,48,33,38,3,23,65,35.4,42,45,9,36,53,127,16,0
132,Oliver Fink,GER,MF,Düsseldorf,36,1982,11.7,38,22,17,17,4,12,38,31.6,26,20,3,17,13,51,19,0
133,Alfreð Finnbogason,ISL,FW,Augsburg,29,1989,14.8,7,3,2,5,0,1,9,11.1,8,6,1,5,3,10,11,0
134,Mark Flekken,NED,GK,Freiburg,25,1993,1.0,0,0,0,0,0,0,0,,0,0,0,0,0,0,0,0
135,Emil Forsberg,SWE,MF|FW,RB Leipzig,26,1991,13.9,12,7,0,12,0,5,16,31.3,11,16,1,15,3,15,6,0
136,Iver Fossum,NOR,MF,Hannover 96,22,1996,5.1,9,5,1,7,1,4,8,50.0,4,8,2,6,7,16,10,0
137,Raphael Framberger,GER,DF|MF,Augsburg,22,1995,6.1,8,6,4,4,0,0,3,0.0,3,10,3,7,11,19,15,1
138,Mike Frantz,GER,MF|FW,Freiburg,31,1986,24.6,34,26,15,15,4,6,20,30.0,14,24,4,20,21,55,32,0
139,Marco Friedl,AUT,DF,Werder Bremen,20,1998,5.3,8,6,4,3,1,3,11,27.3,8,9,6,3,13,21,21,0
140,Alexander Fuchs,GER,MF|FW,Nürnberg,21,1997,7.3,14,12,5,7,2,5,15,33.3,10,9,1,8,5,19,10,0
141,Niclas Füllkrug,GER,FW,Hannover 96,25,1993,12.4,3,0,0,1,2,1,5,20.0,4,10,4,6,1,4,17,0
142,Mijat Gaćinović,SRB,MF,Eint Frankfurt,23,1995,18.1,31,20,7,13,11,11,42,26.2,31,26,1,25,24,55,10,0
143,Jean-Philippe Gbamin,CIV,MF,Mainz 05,22,1995,29.7,51,31,29,15,7,23,51,45.1,28,39,5,34,30,81,32,1
144,Theodor Gebre Selassie,CZE,DF,Werder Bremen,31,1986,31.3,53,38,27,16,10,22,51,43.1,29,33,8,25,69,122,100,0
145,Dennis Geiger,GER,MF,Hoffenheim,20,1998,2.7,2,1,1,1,0,1,6,16.7,5,1,0,1,3,5,1,0
146,Christian Gentner,GER,MF|FW,Stuttgart,32,1985,22.4,61,38,29,26,6,16,50,32.0,34,30,3,27,31,92,41,1
147,Yannick Gerhardt,GER,MF,Wolfsburg,24,1994,27.3,52,34,22,20,10,16,43,37.2,27,35,7,28,30,82,34,0
148,Fabian Giefer,GER,GK,Augsburg,28,1990,4.0,0,0,0,0,0,0,2,0.0,2,0,0,0,0,0,1,2
149,Niko Gießelmann,GER,DF,Düsseldorf,26,1991,28.8,57,37,38,14,5,26,59,44.1,33,25,6,19,36,93,85,1
150,Daniel Ginczek,GER,FW,Wolfsburg,27,1991,14.2,9,7,4,3,2,5,19,26.3,14,12,2,10,3,12,23,1
151,Matthias Ginter,GER,DF,M'Gladbach,24,1994,26.4,24,14,16,7,1,9,17,52.9,8,31,19,12,17,41,98,1
152,Serge Gnabry,GER,FW|MF,Bayern Munich,23,1995,19.6,36,20,12,13,11,5,30,16.7,25,18,0,18,11,47,3,0
153,Kevin Goden,GER,DF|MF,Nürnberg,19,1999,3.0,4,3,3,1,0,2,7,28.6,5,4,1,3,4,8,11,0
154,Mario Gómez,GER,FW,Stuttgart,33,1985,24.6,19,11,6,10,3,2,12,16.7,10,17,6,11,5,24,33,0
155,Jérôme Gondorf,GER,MF|FW,Freiburg,30,1988,14.4,33,18,12,19,2,14,28,50.0,14,29,5,24,19,52,23,1
156,Nicolás González,ARG,FW|MF,Stuttgart,20,1998,24.0,19,14,3,7,9,9,19,47.4,10,32,2,30,11,30,27,0
157,Leon Goretzka,GER,MF,Bayern Munich,23,1995,22.5,41,22,7,27,7,14,38,36.8,24,25,4,21,26,67,14,1
158,Felix Götze,GER,MF,Augsburg,20,1998,1.4,4,2,2,2,0,3,3,100.0,0,1,0,1,3,7,7,0
159,Mario Götze,GER,FW|MF,Dortmund,26,1992,18.6,26,19,6,11,9,4,25,16.0,21,10,0,10,8,34,4,1
160,Jeffrey Gouweleeuw,NED,DF,Augsburg,27,1991,23.2,42,31,23,19,0,24,39,61.5,15,44,21,23,56,98,71,1
161,Michael Gregoritsch,AUT,MF|FW,Augsburg,24,1994,27.6,22,13,7,9,6,4,28,14.3,24,29,10,19,15,37,58,0
162,Vincenzo Grifo,ITA,MF|FW,Hoffenheim,25,1993,3.7,6,3,2,3,1,0,5,0.0,5,2,1,1,2,8,5,0
163,Vincenzo Grifo,ITA,MF|FW,Freiburg,25,1993,15.9,26,14,11,8,7,14,27,51.9,13,10,1,9,2,28,10,0
164,Florian Grillitsch,AUT,MF,Hoffenheim,22,1995,26.6,77,49,30,38,9,36,80,45.0,44,34,8,26,72,149,56,1
165,Marko Grujić,SRB,MF,Hertha BSC,22,1996,19.8,45,33,17,20,8,13,38,34.2,25,29,6,23,29,74,51,1
166,Raphaël Guerreiro,POR,FW|DF,Dortmund,24,1993,17.0,25,12,11,7,7,12,23,52.2,11,7,1,6,18,43,12,1
167,Josuha Guilavogui,FRA,MF,Wolfsburg,27,1990,17.4,31,16,18,13,0,14,25,56.0,11,17,8,9,43,74,56,2
168,Péter Gulácsi,HUN,GK,RB Leipzig,28,1990,32.5,0,0,0,0,0,0,0,,0,0,0,0,0,0,11,0
169,Manuel Gulde,GER,DF,Freiburg,27,1991,19.0,24,16,18,5,1,12,16,75.0,4,25,13,12,26,50,90,0
170,Christian Günter,GER,DF|MF,Freiburg,25,1993,32.0,38,26,16,16,6,20,43,46.5,23,31,7,24,14,52,55,0
171,Ahmet Gürleyen,GER,DF,Mainz 05,19,1999,0.1,0,0,0,0,0,0,0,,0,0,0,0,0,0,1,0
172,Jonathan de Guzmán,NED,MF,Eint Frankfurt,30,1987,17.4,34,24,11,20,3,13,28,46.4,15,18,2,16,11,45,16,0
173,Janik Haberer,GER,MF|FW,Freiburg,24,1994,26.0,71,47,37,24,10,30,75,40.0,45,31,4,27,36,107,49,0
174,Alexander Hack,GER,DF,Mainz 05,24,1993,11.3,29,13,20,9,0,19,28,67.9,9,26,15,11,41,70,59,2
175,Benjamin Hadžić,BIH,FW|MF,Hannover 96,19,1999,0.3,0,0,0,0,0,0,1,0.0,1,0,0,0,0,0,0,0
176,André Hahn,GER,FW|MF,Augsburg,27,1990,22.8,64,38,22,39,3,22,53,41.5,31,28,2,26,27,91,32,0
177,Amadou Haidara,MLI,MF,RB Leipzig,20,1998,4.2,13,11,4,8,1,8,14,57.1,6,9,1,8,4,17,7,0
178,Achraf Hakimi,MAR,DF,Dortmund,19,1998,19.3,34,19,25,8,1,17,36,47.2,19,27,4,23,29,63,45,2
179,Sébastien Haller,CIV,FW,Eint Frankfurt,24,1994,24.2,24,11,7,10,7,8,21,38.1,13,21,1,20,15,39,23,0
180,Marcel Halstenberg,GER,DF|FW,RB Leipzig,26,1991,26.8,68,44,31,24,13,42,65,64.6,23,27,4,23,38,106,69,0
181,Genki Haraguchi,JPN,MF|DF,Hannover 96,27,1991,23.7,44,26,21,20,3,17,66,25.8,49,34,5,29,21,65,33,0
182,Amine Harit,MAR,MF|FW,Schalke 04,21,1997,12.0,15,8,4,9,2,8,24,33.3,16,11,1,10,9,24,2,0
183,Martin Harnik,AUT,FW|MF,Werder Bremen,31,1987,9.2,12,7,4,3,5,4,15,26.7,11,8,0,8,3,15,10,0
184,Makoto Hasebe,JPN,DF|MF,Eint Frankfurt,34,1984,28.0,52,34,35,17,0,25,42,59.5,17,43,22,21,40,92,101,3
185,Kai Havertz,GER,MF|FW,Leverkusen,19,1999,32.2,26,17,10,11,5,8,32,25.0,24,31,4,27,16,42,29,0
186,Thorgan Hazard,BEL,FW|MF,M'Gladbach,25,1993,31.9,50,33,22,20,8,17,48,35.4,31,35,2,33,27,77,12,0
187,Dominique Heintz,GER,DF,Freiburg,24,1993,33.9,41,21,34,6,1,18,32,56.3,14,45,22,23,45,86,214,0
188,Rouwen Hennings,GER,FW,Düsseldorf,30,1987,20.4,14,10,1,8,5,2,13,15.4,11,16,1,15,4,18,20,0
189,Benjamin Henrichs,GER,DF,Leverkusen,21,1997,0.7,0,0,0,0,0,0,0,,0,2,0,2,3,3,0,0
190,Patrick Herrmann,GER,FW|DF,M'Gladbach,27,1991,12.0,20,14,8,7,5,6,17,35.3,11,6,3,3,6,26,12,0
191,Martin Hinteregger,AUT,DF,Augsburg,25,1992,17.5,48,35,31,16,1,24,35,68.6,11,24,13,11,22,70,68,0
192,Martin Hinteregger,AUT,DF,Eint Frankfurt,25,1992,12.7,34,26,19,12,3,13,28,46.4,15,20,7,13,13,47,51,0
193,Marwin Hitz,SUI,GK,Dortmund,30,1987,2.0,0,0,0,0,0,0,0,,0,0,0,0,0,0,0,1
194,André Hoffmann,GER,DF|MF,Düsseldorf,25,1993,11.7,22,14,12,10,0,9,25,36.0,16,17,12,5,21,43,44,0
195,Nicolas Höfler,GER,MF,Freiburg,28,1990,17.9,45,22,19,22,4,14,36,38.9,22,21,4,17,32,77,41,0
196,Jonas Hofmann,GER,MF,M'Gladbach,26,1992,21.2,37,18,11,19,7,9,37,24.3,28,33,2,31,16,53,14,1
197,Lucas Höler,GER,FW,Freiburg,24,1994,11.2,18,13,6,9,3,4,18,22.2,14,10,1,9,3,21,15,2
198,Gerrit Holtmann,PHI,FW|MF,Mainz 05,23,1995,1.6,2,0,1,0,1,1,2,50.0,1,3,2,1,4,6,1,0
199,Justin Hoogma,NED,DF|MF,Hoffenheim,20,1998,1.2,4,2,2,1,1,2,2,100.0,0,3,1,2,2,6,1,0
200,Lukáš Hrádecký,FIN,GK,Leverkusen,28,1989,32.0,0,0,0,0,0,0,1,0.0,1,0,0,0,1,1,9,1
201,Branimir Hrgota,SWE,FW,Eint Frankfurt,25,1993,0.1,0,0,0,0,0,0,0,,0,0,0,0,0,0,0,0
202,Benjamin Hübner,GER,DF,Hoffenheim,29,1989,9.0,29,18,18,9,2,14,18,77.8,4,16,7,9,21,50,35,0
203,Mats Hummels,GER,DF,Bayern Munich,29,1988,19.7,26,17,19,6,1,9,24,37.5,15,20,8,12,34,60,50,1
204,Vedad Ibišević,BIH,FW,Hertha BSC,33,1984,20.1,12,8,2,5,5,0,10,0.0,10,10,4,6,3,15,20,0
205,Ivo Iličević,CRO,MF,Nürnberg,31,1986,0.4,1,0,0,1,0,1,2,50.0,1,1,0,1,0,1,0,0
206,Stefan Ilsanker,AUT,DF|MF,RB Leipzig,29,1989,10.4,26,17,15,10,1,14,23,60.9,9,9,2,7,18,44,43,1
207,Emiliano Insúa,ARG,DF,Stuttgart,29,1989,23.5,51,33,26,18,7,25,42,59.5,17,29,2,27,31,82,55,1
208,Mikael Ishak,SWE,FW,Nürnberg,25,1993,21.3,9,6,3,6,0,3,16,18.8,13,8,3,5,3,12,10,0
209,Gian-Luca Itter,GER,DF,Wolfsburg,19,1999,1.0,4,3,3,1,0,1,2,50.0,1,2,0,2,1,5,2,0
210,Koo Ja-cheol,KOR,MF,Augsburg,29,1989,18.2,36,23,10,20,6,12,30,40.0,18,28,5,23,27,63,21,0
211,Lukas Jäger,AUT,FW|MF,Nürnberg,24,1994,0.3,0,0,0,0,0,0,2,0.0,2,0,0,0,0,0,0,0
212,Christoph Janker,GER,MF|FW,Augsburg,33,1985,0.8,2,1,2,0,0,0,0,,0,1,0,1,0,2,1,0
213,Tony Jantschke,GER,DF,M'Gladbach,28,1990,10.4,15,10,9,5,1,6,8,75.0,2,10,7,3,27,42,51,1
214,Rune Jarstein,NOR,GK,Hertha BSC,33,1984,30.5,0,0,0,0,0,0,0,,0,0,0,0,1,1,8,1
215,Dennis Jastrzembski,POL,FW|DF,Hertha BSC,18,2000,0.7,0,0,0,0,0,0,3,0.0,3,0,0,0,1,1,0,0
216,Tin Jedvaj,CRO,DF,Leverkusen,22,1995,12.5,23,15,9,8,6,10,19,52.6,9,28,2,26,22,45,52,0
217,Fredrik Jensen,FIN,FW|MF,Augsburg,20,1997,2.3,5,4,3,1,1,2,4,50.0,2,6,0,6,2,7,3,0
218,Joelinton,BRA,FW|MF,Hoffenheim,21,1996,23.7,35,22,9,20,6,10,30,33.3,20,36,3,33,14,49,8,0
219,Aron Jóhannsson,USA,MF,Werder Bremen,27,1990,0.0,0,0,0,0,0,0,0,,0,0,0,0,0,0,0,0
220,Fabian Johnson,USA,DF|FW,M'Gladbach,30,1987,11.2,13,5,2,8,3,6,8,75.0,2,8,3,5,10,23,16,0
221,Jonathas,BRA,FW,Hannover 96,29,1989,6.7,7,4,3,4,0,3,10,30.0,7,9,1,8,3,10,4,0
222,Luka Jović,SRB,FW|MF,Eint Frankfurt,20,1997,24.9,10,5,1,8,1,1,12,8.3,11,8,0,8,3,13,30,0
223,Sebastian Jung,GER,DF,Wolfsburg,28,1990,0.6,1,0,0,1,0,1,1,100.0,0,0,0,0,0,1,1,0
224,Ozan Kabak,TUR,DF,Stuttgart,18,2000,15.0,33,19,22,9,2,9,19,47.4,10,15,8,7,23,56,58,1
225,Pavel Kadeřábek,CZE,DF,Hoffenheim,26,1992,27.9,30,19,12,13,5,11,24,45.8,13,37,10,27,34,64,71,1
226,Shinji Kagawa,JPN,MF,Dortmund,29,1989,1.1,0,0,0,0,0,0,0,,0,0,0,0,0,0,0,0
227,Florian Kainz,AUT,FW,Werder Bremen,25,1992,4.1,6,5,5,1,0,3,6,50.0,3,4,1,3,3,9,5,0
228,Salomon Kalou,CIV,FW|MF,Hertha BSC,32,1985,25.7,21,12,5,11,5,6,24,25.0,18,23,1,22,6,27,25,0
229,Marcin Kamiński,POL,DF,Düsseldorf,26,1992,27.0,18,13,14,3,1,7,11,63.6,4,21,11,10,39,57,103,2
230,Patrick Kammerbauer,GER,FW,Freiburg,21,1997,0.0,0,0,0,0,0,0,0,,0,0,0,0,1,1,1,0
231,Kevin Kampl,SVN,MF,RB Leipzig,27,1990,23.5,41,24,16,21,4,8,28,28.6,20,32,2,30,33,74,22,0
232,Stefanos Kapino,GRE,GK,Werder Bremen,24,1994,0.5,0,0,0,0,0,0,0,,0,0,0,0,0,0,0,0
233,Kenan Karaman,TUR,FW|MF,Düsseldorf,24,1994,10.2,13,9,3,10,0,7,12,58.3,5,5,1,4,2,15,8,0
234,Marc-Oliver Kempf,GER,DF,Stuttgart,23,1995,22.5,33,18,26,7,0,12,24,50.0,12,35,21,14,46,79,141,1
235,Sebastian Kerk,GER,MF|FW,Nürnberg,24,1994,13.1,16,9,8,5,3,7,23,30.4,16,14,5,9,3,19,22,1
236,Rani Khedira,GER,DF|MF,Augsburg,24,1994,29.2,56,39,22,28,6,18,36,50.0,18,44,22,22,80,136,95,1
237,Isaac Kiese Thelin,SWE,FW|MF,Leverkusen,26,1992,2.0,2,1,0,2,0,1,2,50.0,1,1,0,1,0,2,4,0
238,Joshua Kimmich,GER,DF|MF,Bayern Munich,23,1995,34.0,46,26,17,22,7,25,54,46.3,29,35,9,26,34,80,41,3
239,Davy Klaassen,NED,MF,Werder Bremen,25,1993,31.3,64,47,24,33,7,14,49,28.6,35,44,9,35,47,111,47,0
240,Felix Klaus,GER,FW|MF,Wolfsburg,25,1992,4.9,10,7,4,5,1,2,7,28.6,5,5,0,5,4,14,0,0
241,Tim Kleindienst,GER,FW,Freiburg,22,1995,2.2,4,3,1,2,1,1,3,33.3,2,3,0,3,0,4,7,0
242,Lukas Klostermann,GER,DF,RB Leipzig,22,1996,22.3,50,29,33,12,5,29,45,64.4,16,37,5,32,29,79,74,0
243,Lukas Klünter,GER,DF,Hertha BSC,22,1996,6.6,11,8,6,5,0,4,5,80.0,1,6,2,4,12,23,20,0
244,Robin Knoche,GER,DF,Wolfsburg,26,1992,31.0,26,20,19,6,1,16,29,55.2,13,46,29,17,44,70,138,2
245,Törles Knöll,GER,FW|MF,Nürnberg,20,1997,4.1,3,2,1,1,1,0,4,0.0,4,5,1,4,0,3,2,0
246,Gregor Kobel,SUI,GK,Hoffenheim,20,1997,1.0,0,0,0,0,0,0,0,,0,0,0,0,0,0,0,0
247,Gregor Kobel,SUI,GK,Augsburg,20,1997,15.4,1,1,1,0,0,1,1,100.0,0,0,0,0,2,3,5,3
248,Robin Koch,GER,MF|DF,Freiburg,22,1996,21.1,25,14,17,7,1,7,24,29.2,17,31,18,13,32,57,77,4
249,Dominik Kohr,GER,MF,Leverkusen,24,1994,10.8,42,29,21,21,0,14,35,40.0,21,25,12,13,15,57,17,1
250,Ibrahima Konaté,FRA,DF,RB Leipzig,19,1999,27.0,44,32,30,14,0,17,27,63.0,10,29,18,11,58,102,126,0
251,Yevhen Konoplyanka,UKR,FW|MF,Schalke 04,28,1989,7.3,2,0,0,0,2,2,4,50.0,2,6,0,6,3,5,3,0
252,Pascal Köpke,GER,FW|MF,Hertha BSC,22,1995,0.8,1,0,1,0,0,1,2,50.0,1,0,0,0,0,1,0,0
253,Julian Korb,GER,DF,Hannover 96,26,1992,11.2,26,17,16,9,1,10,29,34.5,19,27,4,23,23,49,34,1
254,Filip Kostić,SRB,DF|FW,Eint Frankfurt,25,1992,32.8,64,42,35,22,7,23,65,35.4,42,80,6,74,23,87,50,0
255,Dawid Kownacki,POL,MF|FW,Düsseldorf,21,1997,6.4,13,6,9,3,1,7,16,43.8,9,8,0,8,2,15,8,0
256,Thomas Kraft,GER,GK,Hertha BSC,30,1988,3.5,0,0,0,0,0,0,0,,0,0,0,0,0,0,1,1
257,Andrej Kramarić,CRO,MF|FW,Hoffenheim,27,1991,26.6,9,4,1,5,3,4,26,15.4,22,15,3,12,8,17,13,0
258,Christoph Kramer,GER,MF,M'Gladbach,27,1991,12.6,41,22,17,23,1,15,40,37.5,25,19,4,15,21,62,23,0
259,Max Kruse,GER,FW|MF,Werder Bremen,30,1988,31.5,17,5,2,13,2,6,38,15.8,32,16,1,15,8,25,6,2
260,Lukas Kübler,GER,DF|MF,Freiburg,25,1992,13.2,35,22,23,12,0,16,26,61.5,10,15,5,10,30,65,50,1
261,Yuya Kubo,JPN,FW|MF,Nürnberg,24,1993,15.1,21,11,6,10,5,12,33,36.4,21,11,0,11,10,31,6,0
262,Pierre Kunde,CMR,MF,Mainz 05,23,1995,21.2,48,29,20,26,2,16,27,59.3,11,34,14,20,24,72,49,1
263,Ahmed Kutucu,TUR,FW|MF,Schalke 04,18,2000,4.7,8,3,3,4,1,1,3,33.3,2,2,1,1,0,8,0,0
264,Konrad Laimer,AUT,MF|DF,RB Leipzig,21,1997,20.8,72,38,21,34,17,20,71,28.2,51,67,2,65,32,104,23,0
265,Michael Lang,SUI,DF,M'Gladbach,27,1991,13.9,14,9,7,6,1,6,16,37.5,10,14,3,11,16,30,42,1
266,Sebastian Langkamp,GER,DF,Werder Bremen,30,1988,15.7,24,15,18,6,0,7,14,50.0,7,17,11,6,20,44,79,1
267,Danny Latza,GER,MF,Mainz 05,28,1989,20.7,41,22,16,23,2,20,61,32.8,41,49,10,39,20,61,31,0
268,Valentino Lazaro,AUT,DF|FW,Hertha BSC,22,1996,30.5,46,31,23,17,6,21,53,39.6,32,52,12,40,44,90,65,0
269,Mathew Leckie,AUS,FW|MF,Hertha BSC,27,1991,10.5,20,13,5,10,5,7,16,43.8,9,10,1,9,13,33,16,0
270,Tim Leibold,GER,DF,Nürnberg,24,1993,30.7,62,42,45,16,1,33,71,46.5,38,23,3,20,38,100,57,0
271,Robert Lewandowski,POL,FW,Bayern Munich,29,1988,32.9,12,9,0,8,4,3,11,27.3,8,11,1,10,7,19,15,0
272,Philipp Lienhart,AUT,DF,Freiburg,22,1996,6.8,6,6,4,2,0,3,6,50.0,3,9,7,2,11,17,42,0
273,Davor Lovren,CRO,MF,Düsseldorf,19,1998,0.5,1,1,0,0,1,0,0,,0,1,0,1,0,1,0,0
274,Eduard Löwen,GER,MF|FW,Nürnberg,21,1997,18.0,30,22,14,13,3,11,34,32.4,23,15,2,13,8,38,23,0
275,Derrick Luckassen,NED,DF,Hertha BSC,23,1995,2.8,4,2,4,0,0,1,3,33.3,2,1,0,1,0,4,13,0
276,Dodi Lukebakio,BEL,FW|MF,Düsseldorf,20,1997,21.9,25,17,11,6,8,8,15,53.3,7,13,0,13,9,34,19,0
277,Fabian Lustenberger,SUI,DF|MF,Hertha BSC,30,1988,24.1,45,30,23,21,1,15,33,45.5,18,39,18,21,39,84,108,2
278,Andreas Luthe,GER,GK,Augsburg,31,1987,14.6,0,0,0,0,0,0,0,,0,0,0,0,0,0,4,0
279,Pablo Maffeo,ESP,DF|MF,Stuttgart,21,1997,6.6,15,13,10,5,0,6,13,46.2,7,8,4,4,13,28,17,0
280,Arne Maier,GER,MF,Hertha BSC,19,1999,22.9,31,16,12,19,0,6,25,24.0,19,32,9,23,28,59,35,0
281,Linton Maina,GER,FW|MF,Hannover 96,19,1999,15.7,28,14,13,10,5,12,23,52.2,11,20,0,20,14,42,4,0
282,Yunus Mallı,TUR,MF|FW,Wolfsburg,26,1992,7.8,15,7,8,6,1,2,11,18.2,9,2,0,2,4,19,1,0
283,Georg Margreitter,AUT,DF,Nürnberg,29,1988,22.9,39,24,28,8,3,31,38,81.6,7,29,26,3,26,65,141,0
284,Aarón Martín,ESP,DF,Mainz 05,21,1997,32.0,55,30,29,21,5,20,38,52.6,18,38,11,27,38,93,75,1
285,Javi Martínez,ESP,MF,Bayern Munich,29,1988,14.5,26,15,7,17,2,5,16,31.3,11,17,5,12,31,57,13,0
286,Omar Mascarell,ESP,MF,Schalke 04,25,1993,11.0,20,10,9,9,2,10,24,41.7,14,21,7,14,23,43,8,0
287,Jean-Philippe Mateta,FRA,FW,Mainz 05,21,1997,27.6,13,9,4,4,5,1,10,10.0,9,15,2,13,3,16,22,0
288,Christian Mathenia,GER,GK,Nürnberg,26,1992,21.5,0,0,0,0,0,0,0,,0,1,0,1,1,1,18,2
289,Rabbi Matondo,WAL,FW|MF,Schalke 04,17,2000,2.1,4,1,4,0,0,1,5,20.0,4,2,0,2,0,4,1,0
290,Philipp Max,GER,DF|MF,Augsburg,24,1993,28.5,35,24,17,15,3,21,39,53.8,18,16,3,13,22,57,46,1
291,Alexandru Maxim,ROU,MF|FW,Mainz 05,28,1990,6.4,16,10,6,9,1,10,19,52.6,9,12,0,12,5,21,7,0
292,Weston McKennie,USA,MF|FW,Schalke 04,19,1998,19.4,28,14,5,17,6,11,35,31.4,24,28,9,19,36,64,46,1
293,Admir Mehmedi,SUI,FW|MF,Wolfsburg,27,1991,18.8,46,28,19,19,8,18,44,40.9,26,25,0,25,12,58,9,0
294,Hamza Mendyl,MAR,DF,Schalke 04,20,1997,6.0,17,15,6,8,3,8,18,44.4,10,11,2,9,8,25,8,0
295,Virgil Misidjan,NED,MF|FW,Nürnberg,25,1993,17.1,21,13,10,5,6,4,25,16.0,21,17,0,17,9,30,5,0
296,Maximilian Mittelstädt,GER,DF|MF,Hertha BSC,21,1997,20.0,61,37,33,23,5,23,49,46.9,26,32,4,28,46,107,64,0
297,Kevin Möhwald,GER,MF,Werder Bremen,25,1993,9.7,16,10,3,11,2,3,20,15.0,17,14,0,14,17,33,14,0
298,Niklas Moisander,FIN,DF,Werder Bremen,32,1985,29.3,34,23,26,8,0,22,51,43.1,29,42,19,23,39,73,140,2
299,Alfredo Morales,USA,MF,Düsseldorf,28,1990,17.0,32,18,16,15,1,6,24,25.0,18,18,9,9,24,56,31,0
300,Jan Morávek,CZE,MF,Augsburg,28,1989,8.4,38,21,17,16,5,19,42,45.2,23,21,1,20,9,47,13,0
301,Lukas Mühl,GER,DF,Nürnberg,21,1997,31.0,57,34,49,6,2,32,51,62.7,19,53,18,35,48,105,139,2
302,Nordi Mukiele,FRA,DF,RB Leipzig,20,1997,13.6,38,21,23,12,3,19,22,86.4,3,17,3,14,24,62,35,0
303,Florian Müller,GER,GK,Mainz 05,20,1997,24.0,1,1,1,0,0,1,2,50.0,1,0,0,0,3,4,8,5
304,Nicolai Müller,GER,MF|FW,Hannover 96,30,1987,10.0,18,9,7,7,4,8,27,29.6,19,9,1,8,1,19,7,0
305,Nicolai Müller,GER,FW|MF,Eint Frankfurt,30,1987,2.4,4,2,3,1,0,1,2,50.0,1,4,1,3,0,4,0,0
306,Thomas Müller,GER,MF|FW,Bayern Munich,28,1989,26.4,42,23,13,15,14,10,38,26.3,28,46,6,40,9,51,12,0
307,Florent Muslija,KVX,MF|FW,Hannover 96,20,1998,7.5,16,10,8,6,2,8,12,66.7,4,4,0,4,3,19,4,0
308,Yvon Mvogo,SUI,GK,RB Leipzig,24,1994,1.5,0,0,0,0,0,0,0,,0,0,0,0,0,0,1,0
309,Phillipp Mwene,AUT,DF|MF,Mainz 05,24,1994,3.0,7,2,3,4,0,5,6,83.3,1,6,0,6,6,13,10,0
310,Obite N'Dicka,CIV,DF,Eint Frankfurt,18,1999,25.6,43,28,31,10,2,31,52,59.6,21,29,11,18,29,72,123,0
311,Naldo,BRA,DF,Schalke 04,35,1982,7.0,10,7,8,2,0,5,8,62.5,3,8,3,5,14,24,25,0
312,Matija Nastasić,SRB,DF,Schalke 04,25,1993,27.2,35,23,22,13,0,20,29,69.0,9,32,20,12,38,73,114,1
313,Reiss Nelson,ENG,MF|FW,Hoffenheim,18,1999,7.1,17,10,8,4,5,2,13,15.4,11,12,1,11,5,22,2,0
314,Manuel Neuer,GER,GK,Bayern Munich,32,1986,25.6,1,1,1,0,0,0,1,0.0,1,1,0,1,0,1,8,3
315,Florian Neuhaus,GER,MF,M'Gladbach,21,1997,22.9,22,15,9,9,4,10,36,27.8,26,20,1,19,10,32,23,0
316,Moussa Niakhate,SEN,DF,Mainz 05,22,1996,31.0,49,30,35,12,2,20,33,60.6,13,42,24,18,44,93,143,1
317,Florian Niederlechner,GER,FW|MF,Freiburg,27,1990,10.8,7,5,1,4,2,0,5,0.0,5,12,4,8,6,13,10,0
318,Håvard Nordtveit,NOR,MF|DF,Hoffenheim,28,1990,5.2,8,5,2,4,2,3,7,42.9,4,8,5,3,4,12,14,0
319,Alexander Nübel,GER,GK,Schalke 04,21,1996,17.6,0,0,0,0,0,0,1,0.0,1,0,0,0,1,1,4,1
320,Kasim Nuhu,GHA,DF,Hoffenheim,23,1995,10.0,19,11,14,3,2,10,23,43.5,13,11,5,6,23,42,44,0
321,Hans Nunoo Sarpei,GHA,FW|MF,Stuttgart,19,1998,0.5,1,1,0,1,0,0,0,,0,0,0,0,0,1,0,0
322,Bastian Oczipka,GER,DF|FW,Schalke 04,29,1989,20.8,41,27,20,19,2,21,26,80.8,5,23,5,18,24,65,24,2
323,Chima Okoroji,NGA,DF|MF,Freiburg,21,1997,1.2,3,0,1,1,1,1,1,100.0,0,0,0,0,1,4,1,0
324,Karim Onisiwo,AUT,FW|MF,Mainz 05,26,1992,12.9,23,15,6,12,5,4,12,33.3,8,14,3,11,9,32,13,0
325,Willi Orban,HUN,DF,RB Leipzig,25,1992,22.8,49,26,31,15,3,24,38,63.2,14,33,15,18,36,85,140,0
326,Yuya Osako,JPN,FW|MF,Werder Bremen,28,1990,15.0,23,11,6,12,5,7,22,31.8,15,15,3,12,7,30,8,0
327,Matthias Ostrzolek,GER,DF,Hannover 96,28,1990,16.3,32,18,24,8,0,20,33,60.6,13,20,5,15,26,58,44,2
328,David Otto,GER,MF|FW,Hoffenheim,19,1999,0.3,2,1,1,1,0,0,1,0.0,1,0,0,0,0,2,0,0
329,Reece Oxford,ENG,DF,Augsburg,19,1998,5.6,12,9,9,3,0,4,6,66.7,2,10,9,1,11,23,39,0
330,Berkay Özcan,TUR,MF|DF,Stuttgart,20,1998,0.6,0,0,0,0,0,0,0,,0,1,0,1,0,0,0,0
331,Ramazan Özcan,AUT,GK,Leverkusen,34,1984,2.0,0,0,0,0,0,0,0,,0,0,0,0,1,1,2,0
332,Levin Öztunalı,GER,MF|FW,Mainz 05,22,1996,10.2,17,7,5,9,3,4,18,22.2,14,14,2,12,7,24,10,0
333,Gonçalo Paciência,POR,FW,Eint Frankfurt,23,1994,4.3,3,2,0,2,1,1,2,50.0,1,8,1,7,0,3,1,0
334,Federico Palacios Martínez,GER,MF|FW,Nürnberg,23,1995,10.5,21,10,11,8,2,10,20,50.0,10,10,0,10,9,30,4,0
335,Paulinho,BRA,FW|MF,Leverkusen,18,2000,2.0,4,4,2,2,0,1,2,50.0,1,3,0,3,2,6,0,1
336,Benjamin Pavard,FRA,DF,Stuttgart,22,1996,29.0,28,20,21,6,1,12,19,63.2,7,27,19,8,48,76,189,2
337,Jiří Pavlenka,CZE,GK,Werder Bremen,26,1992,33.1,3,0,3,0,0,3,6,50.0,3,1,0,1,3,6,14,1
338,Peter Pekarík,SVK,DF,Hertha BSC,31,1986,2.4,2,1,1,1,0,1,3,33.3,2,2,1,1,1,3,5,0
339,Matheus Pereira,POR,MF|FW,Nürnberg,22,1996,13.7,16,11,4,8,4,2,13,15.4,11,15,2,13,14,30,7,0
340,Pavao Pervan,AUT,GK,Wolfsburg,30,1987,8.5,0,0,0,0,0,0,0,,0,0,0,0,0,0,3,1
341,Nils Petersen,GER,FW,Freiburg,29,1988,21.4,29,21,10,16,3,4,24,16.7,20,28,2,26,13,42,34,0
342,Ondřej Petrák,CZE,MF,Nürnberg,26,1992,18.0,36,24,17,18,1,14,25,56.0,11,18,4,14,40,76,22,0
343,Maximilian Philipp,GER,FW|MF,Dortmund,24,1994,8.4,7,5,3,4,0,2,9,22.2,7,10,0,10,3,10,6,0
344,Łukasz Piszczek,POL,DF,Dortmund,33,1985,19.5,57,36,34,15,8,18,33,54.5,15,26,3,23,39,96,69,0
345,Claudio Pizarro,PER,FW,Werder Bremen,39,1978,7.7,10,6,4,2,4,4,7,57.1,3,14,1,13,1,11,7,0
346,Marvin Plattenhardt,GER,DF,Hertha BSC,26,1992,21.4,27,21,12,10,5,14,21,66.7,7,18,3,15,7,34,56,0
347,Alassane Pléa,FRA,FW,M'Gladbach,25,1993,27.8,14,10,7,4,3,5,22,22.7,17,17,2,15,3,17,15,2
348,Luca Plogmann,GER,GK,Werder Bremen,18,2000,0.4,0,0,0,0,0,0,0,,0,0,0,0,0,0,0,0
349,Stefan Posch,AUT,DF,Hoffenheim,21,1997,15.6,45,32,28,15,2,17,28,60.7,11,26,11,15,21,66,58,0
350,Yussuf Poulsen,DEN,FW,RB Leipzig,24,1994,27.2,20,10,5,10,5,3,25,12.0,22,33,2,31,7,27,28,0
351,Edgar Prib,GER,MF,Hannover 96,28,1989,2.2,10,9,3,5,2,2,4,50.0,2,4,0,4,2,12,1,0
352,Christian Pulisic,USA,FW,Dortmund,19,1998,10.4,10,6,2,6,2,2,6,33.3,4,12,2,10,6,16,10,0
353,Robin Quaison,SWE,FW|MF,Mainz 05,24,1993,24.4,19,12,3,10,6,5,12,41.7,7,9,1,8,7,26,4,0
354,Raffael,BRA,FW,M'Gladbach,33,1985,6.0,8,4,2,4,2,2,7,28.6,5,5,0,5,1,9,0,0
355,Rafinha,BRA,DF,Bayern Munich,32,1985,10.0,15,7,6,6,3,6,14,42.9,8,8,3,5,19,34,11,0
356,Baba Rahman,GHA,DF,Schalke 04,24,1994,1.8,3,1,1,1,1,1,1,100.0,0,3,0,3,2,5,2,0
357,Benito Raman,BEL,MF|FW,Düsseldorf,23,1994,18.7,35,20,14,16,5,11,53,20.8,42,30,2,28,15,50,8,0
358,Milot Rashica,KVX,FW|MF,Werder Bremen,22,1996,17.2,24,16,8,11,5,9,24,37.5,15,16,2,14,6,30,6,1
359,Yoric Ravet,FRA,FW|MF,Freiburg,28,1989,0.8,2,1,1,0,1,1,2,50.0,1,2,1,1,0,2,1,0
360,Ante Rebić,CRO,FW|MF,Eint Frankfurt,24,1993,22.0,22,9,5,12,5,5,12,41.7,7,18,1,17,8,30,3,0
361,Karim Rekik,NED,DF,Hertha BSC,23,1994,23.0,36,22,23,12,1,12,18,66.7,6,24,16,8,34,70,88,0
362,Michael Rensing,GER,GK,Düsseldorf,34,1984,32.0,2,1,2,0,0,1,5,20.0,4,1,0,1,2,4,13,2
363,Marco Reus,GER,MF|FW,Dortmund,29,1989,25.7,33,22,11,16,6,6,31,19.4,25,28,1,27,8,41,32,0
364,Elvis Rexhbeçaj,GER,MF,Wolfsburg,20,1997,12.7,28,18,11,12,5,12,24,50.0,12,18,2,16,14,42,21,0
365,Simon Rhein,GER,MF,Nürnberg,20,1998,5.5,7,4,7,0,0,2,7,28.6,5,6,1,5,7,14,6,0
366,Franck Ribéry,FRA,MF|FW,Bayern Munich,35,1983,13.0,15,7,7,6,2,4,10,40.0,6,9,0,9,7,22,1,0
367,Marco Richter,GER,MF|FW,Augsburg,20,1997,15.8,13,8,4,5,4,7,20,35.0,13,16,1,15,13,26,9,1
368,Sascha Riether,GER,FW,Schalke 04,35,1983,0.0,0,0,0,0,0,0,0,,0,0,0,0,0,0,0,0
369,Arjen Robben,NED,FW|MF,Bayern Munich,34,1984,6.3,3,1,0,3,0,0,1,0.0,1,6,1,5,3,6,0,0
370,Sebastian Rode,GER,MF,Eint Frankfurt,27,1990,10.3,31,19,17,9,5,16,35,45.7,19,17,0,17,19,50,14,0
371,James Rodríguez,COL,MF,Bayern Munich,27,1991,12.6,12,8,3,4,5,5,19,26.3,14,9,0,9,4,16,1,0
372,Jérôme Roussillon,FRA,DF,Wolfsburg,25,1993,27.3,42,29,25,15,2,20,30,66.7,10,50,7,43,31,73,54,0
373,Sebastian Rudy,GER,MF,Schalke 04,28,1990,15.1,44,24,11,27,6,11,41,26.8,30,23,2,21,15,59,15,0
374,Lukas Rupp,GER,MF|DF,Hoffenheim,27,1991,0.3,1,1,0,0,1,0,0,,0,0,0,0,0,1,0,0
375,Marco Russ,GER,DF,Eint Frankfurt,32,1985,4.2,7,2,5,2,0,4,6,66.7,2,2,2,0,7,14,8,0
376,Frederik Rønnow,DEN,GK,Eint Frankfurt,25,1992,1.4,0,0,0,0,0,0,0,,0,0,0,0,0,0,1,0
377,Marcel Sabitzer,AUT,MF,RB Leipzig,24,1994,26.1,45,28,17,21,7,18,46,39.1,28,21,2,19,33,78,31,0
378,Nuri Şahin,TUR,MF,Werder Bremen,29,1988,16.4,60,33,22,33,5,23,59,39.0,36,30,3,27,37,97,39,1
379,Samuel Şahin-Radlinger,AUT,GK,Hannover 96,25,1992,1.0,0,0,0,0,0,0,0,,0,1,0,1,0,0,2,0
380,Carlos Salcedo,MEX,DF,Eint Frankfurt,24,1993,5.1,7,3,4,3,0,4,7,57.1,3,7,3,4,9,16,22,0
381,Roland Sallai,HUN,MF,Freiburg,21,1997,5.9,12,7,5,5,2,5,13,38.5,8,3,0,3,3,15,8,0
382,Edgar Salli,CMR,FW|MF,Nürnberg,25,1992,1.3,2,1,1,1,0,0,1,0.0,1,0,0,0,1,3,1,0
383,Renato Sanches,POR,MF,Bayern Munich,20,1997,6.4,5,5,2,1,2,3,10,30.0,7,7,0,7,4,9,2,0
384,Jadon Sancho,ENG,FW|MF,Dortmund,18,2000,27.3,19,10,7,6,6,10,31,32.3,21,21,1,20,14,33,12,1
385,Salif Sané,SEN,DF,Schalke 04,27,1990,29.0,54,37,34,19,1,27,46,58.7,19,44,29,15,68,122,146,3
386,Marcelo Saracchi,URU,DF,RB Leipzig,20,1998,7.3,17,11,12,4,1,8,13,61.5,5,12,1,11,11,28,14,0
387,Josh Sargent,USA,FW,Werder Bremen,18,2000,2.4,2,1,1,0,1,2,2,100.0,0,2,0,2,0,2,3,0
388,Julian Schieber,GER,FW,Augsburg,29,1989,2.9,3,2,1,2,0,0,1,0.0,1,1,0,1,1,4,3,0
389,Keven Schlotterbeck,GER,DF,Freiburg,21,1997,8.6,22,16,19,2,1,8,12,66.7,4,17,11,6,13,35,26,0
390,Nico Schlotterbeck,GER,DF,Freiburg,18,1999,2.5,6,6,6,0,0,2,2,100.0,0,3,1,2,5,11,10,0
391,Marcel Schmelzer,GER,DF,Dortmund,30,1988,6.3,10,5,7,2,1,5,9,55.6,4,7,1,6,9,19,14,0
392,Jonathan Schmid,FRA,DF,Augsburg,28,1990,28.0,44,22,23,19,2,16,28,57.1,12,22,8,14,43,87,70,2
393,Alessandro Schöpf,AUT,MF|DF,Schalke 04,24,1994,11.2,26,16,12,13,1,12,29,41.4,17,14,0,14,9,35,12,0
394,Nico Schulz,GER,DF,Hoffenheim,25,1993,28.2,34,20,19,12,3,15,36,41.7,21,32,4,28,24,58,36,0
395,Pirmin Schwegler,SUI,MF,Hannover 96,31,1987,23.1,63,34,30,29,4,34,60,56.7,26,21,5,16,41,104,54,0
396,Alexander Schwolow,GER,GK,Freiburg,26,1992,33.0,0,0,0,0,0,0,1,0.0,1,0,0,0,0,0,13,2
397,Davie Selke,GER,FW,Hertha BSC,23,1995,19.3,5,2,1,4,0,2,9,22.2,7,11,0,11,1,6,7,0
398,Suat Serdar,GER,MF,Schalke 04,21,1997,19.2,51,32,20,26,5,14,49,28.6,35,37,6,31,23,74,5,1
399,Meritan Shabani,ALB,MF,Bayern Munich,19,1999,0.0,0,0,0,0,0,0,0,,0,0,0,0,0,0,0,0
400,Steven Skrzybski,GER,FW|MF,Schalke 04,25,1992,7.4,9,3,0,6,3,3,11,27.3,8,8,1,7,3,12,2,0
401,Emile Smith Rowe,ENG,MF,RB Leipzig,18,2000,0.3,1,0,0,1,0,1,1,100.0,0,0,0,0,1,2,0,0
402,Marcel Sobottka,GER,MF,Düsseldorf,24,1994,10.5,30,20,12,18,0,10,19,52.6,9,13,5,8,24,54,17,0
403,Yann Sommer,SUI,GK,M'Gladbach,29,1988,34.0,2,2,2,0,0,2,2,100.0,0,1,0,1,1,3,12,5
404,Oliver Sorg,GER,DF,Hannover 96,28,1990,17.6,42,28,26,16,0,20,43,46.5,23,16,9,7,46,88,47,0
405,Borna Sosa,CRO,DF|MF,Stuttgart,20,1998,6.8,13,7,8,4,1,4,9,44.4,5,5,1,4,6,19,34,0
406,Sebastian Soto,USA,MF|FW,Hannover 96,18,2000,0.3,0,0,0,0,0,0,0,,0,0,0,0,0,0,0,0
407,Kostas Stafylidis,GRE,DF,Augsburg,24,1993,10.2,22,14,17,4,1,10,19,52.6,9,13,2,11,15,37,31,0
408,Benjamin Stambouli,FRA,DF|MF,Schalke 04,27,1990,19.6,51,31,24,24,3,25,46,54.3,21,41,9,32,32,83,65,2
409,Jozo Stanić,CRO,MF,Augsburg,19,1999,0.0,0,0,0,0,0,0,0,,0,0,0,0,0,0,0,0
410,Niklas Stark,GER,DF,Hertha BSC,23,1995,20.8,34,19,23,11,0,9,24,37.5,15,45,26,19,37,71,141,1
411,Renato Steffen,SUI,FW|MF,Wolfsburg,26,1991,16.7,26,17,5,17,4,7,17,41.2,10,13,2,11,16,42,14,0
412,Marc Stendera,GER,MF,Eint Frankfurt,22,1995,1.2,6,1,2,4,0,2,4,50.0,2,4,1,3,0,6,0,0
413,Pascal Stenzel,GER,DF|MF,Freiburg,22,1996,16.1,42,26,26,14,2,24,43,55.8,19,16,3,13,30,72,48,1
414,Lars Stindl,GER,FW|MF,M'Gladbach,29,1988,16.8,21,14,8,11,2,3,15,20.0,12,22,2,20,14,35,13,0
415,Kevin Stöger,AUT,MF,Düsseldorf,24,1993,23.5,63,35,28,27,8,30,67,44.8,37,32,5,27,31,94,19,1
416,Tobias Strobl,GER,MF|DF,M'Gladbach,28,1990,25.5,31,17,17,13,1,9,29,31.0,20,36,14,22,29,60,35,1
417,Niklas Süle,GER,DF,Bayern Munich,22,1995,29.5,28,23,17,10,1,18,25,72.0,7,23,13,10,40,68,83,0
418,Markus Suttner,AUT,DF|MF,Düsseldorf,31,1987,5.4,10,7,5,4,1,4,8,50.0,4,8,3,5,8,18,10,0
419,Ádám Szalai,HUN,FW,Hoffenheim,30,1987,18.1,19,13,3,12,4,4,11,36.4,7,8,1,7,4,23,8,0
420,Jonathan Tah,GER,DF,Leverkusen,22,1996,32.6,44,30,30,10,4,17,32,53.1,15,39,26,13,45,89,142,1
421,Taleb Tawatha,ISR,FW|DF,Eint Frankfurt,26,1992,1.4,1,1,1,0,0,1,2,50.0,1,0,0,0,0,1,1,0
422,Georg Teigl,AUT,MF|FW,Augsburg,27,1991,3.3,5,3,4,0,1,2,2,100.0,0,1,0,1,7,12,5,1
423,Marco Terrazzino,GER,MF|FW,Freiburg,27,1991,5.7,6,3,4,2,0,1,7,14.3,6,5,2,3,3,9,2,0
424,Cedric Teuchert,GER,FW|MF,Schalke 04,21,1997,1.8,0,0,0,0,0,0,0,,0,2,0,2,1,1,0,0
425,Erik Thommy,GER,MF|FW,Stuttgart,23,1994,8.8,5,3,3,1,1,1,7,14.3,6,16,1,15,14,19,4,0
426,Timothy Tillman,GER,FW|MF,Nürnberg,19,1999,2.3,0,0,0,0,0,0,4,0.0,4,3,0,3,3,3,0,2
427,George Timotheou,AUS,DF,Schalke 04,21,1997,1.0,3,3,3,0,0,0,0,,0,1,1,0,1,4,4,0
428,Marcel Tisserand,COD,DF,Wolfsburg,25,1993,9.8,14,9,9,5,0,10,13,76.9,3,12,5,7,20,34,42,1
429,Corentin Tolisso,FRA,MF,Bayern Munich,23,1994,0.6,0,0,0,0,0,0,2,0.0,2,1,1,0,0,0,0,0
430,Ömer Toprak,TUR,DF,Dortmund,29,1989,2.6,1,1,0,1,0,0,1,0.0,1,1,1,0,0,1,7,0
431,Lucas Torró,ESP,MF,Eint Frankfurt,24,1994,6.2,14,7,5,7,2,5,11,45.5,6,12,1,11,14,28,13,0
432,Jordan Torunarigha,GER,DF,Hertha BSC,20,1997,12.9,34,30,23,10,1,18,28,64.3,10,19,7,12,29,63,55,0
433,Almamy Touré,MLI,DF|MF,Eint Frankfurt,22,1996,5.8,18,11,7,11,0,5,8,62.5,3,4,1,3,9,27,25,0
434,Ibrahima Traoré,GUI,FW|MF,M'Gladbach,30,1988,6.1,12,6,8,2,2,3,11,27.3,8,3,1,2,3,15,1,0
435,Kevin Trapp,GER,GK,Eint Frankfurt,28,1990,32.6,0,0,0,0,0,0,2,0.0,2,0,0,0,0,0,17,1
436,Philipp Tschauner,GER,GK,Hannover 96,32,1985,1.0,0,0,0,0,0,0,0,,0,0,0,0,0,0,0,0
437,Anthony Ujah,NGA,FW,Mainz 05,27,1990,8.2,2,0,0,1,1,1,2,50.0,1,7,2,5,1,3,10,0
438,Sven Ulreich,GER,GK,Bayern Munich,29,1988,8.4,0,0,0,0,0,0,0,,0,0,0,0,0,0,2,1
439,Dayot Upamecano,FRA,DF,RB Leipzig,19,1998,14.4,22,16,14,8,0,15,18,83.3,3,19,5,14,33,55,47,0
440,Takashi Usami,JPN,MF|FW,Düsseldorf,26,1992,9.8,18,12,7,11,0,9,26,34.6,17,15,2,13,8,26,13,1
441,Mark Uth,GER,FW|MF,Schalke 04,26,1991,15.6,20,11,8,8,4,4,23,17.4,19,19,2,17,8,28,12,0
442,Enrico Valentini,ITA,DF,Nürnberg,29,1989,14.4,44,27,31,10,3,22,40,55.0,18,17,3,14,13,57,58,0
443,Miloš Veljković,SRB,DF,Werder Bremen,22,1995,20.9,36,24,29,6,1,22,37,59.5,15,27,13,14,27,63,111,0
444,Paul Verhaegh,NED,DF,Wolfsburg,34,1983,2.0,1,0,0,0,1,1,2,50.0,1,5,0,5,1,2,7,1
445,Kevin Vogt,GER,DF,Hoffenheim,26,1991,26.6,24,15,20,4,0,12,32,37.5,20,28,11,17,33,57,103,3
446,Kevin Volland,GER,FW,Leverkusen,26,1992,31.3,33,20,7,14,12,13,27,48.1,14,17,1,16,6,39,33,0
447,Sandro Wagner,GER,FW,Bayern Munich,30,1987,1.6,3,2,0,2,1,0,1,0.0,1,0,0,0,0,3,2,0
448,Walace,BRA,MF,Hannover 96,23,1995,22.2,52,22,17,28,7,27,61,44.3,34,30,4,26,45,97,36,1
449,Luca Waldschmidt,GER,FW|MF,Freiburg,22,1996,19.1,20,13,7,10,3,2,20,10.0,18,20,3,17,13,33,8,1
450,Wout Weghorst,NED,FW,Wolfsburg,25,1992,32.5,30,23,10,12,8,7,35,20.0,28,27,3,24,9,39,33,0
451,Julian Weigl,GER,DF|MF,Dortmund,22,1995,16.2,32,18,19,12,1,24,41,58.5,17,18,10,8,16,48,56,2
452,Mitchell Weiser,GER,DF,Leverkusen,24,1994,23.5,63,37,34,22,7,26,50,52.0,24,31,3,28,27,90,48,0
453,Wendell,BRA,DF,Leverkusen,25,1993,25.3,75,48,47,24,4,34,57,59.6,23,49,13,36,29,104,66,0
454,Oscar Wendt,SWE,DF,M'Gladbach,32,1985,30.3,45,34,34,8,3,31,53,58.5,22,37,11,26,19,64,90,0
455,Timo Werner,GER,FW,RB Leipzig,22,1996,27.9,18,12,6,8,4,3,16,18.8,13,18,2,16,3,21,7,0
456,Hendrik Weydandt,GER,FW,Hannover 96,23,1995,19.1,18,12,7,8,3,3,24,12.5,21,14,4,10,5,23,44,0
457,Jetro Willems,NED,MF|DF,Eint Frankfurt,24,1994,8.1,20,15,10,8,2,9,15,60.0,6,10,4,6,10,30,14,0
458,William,BRA,DF,Wolfsburg,23,1995,29.7,82,57,52,21,9,35,75,46.7,40,41,2,39,85,167,127,3
459,Kevin Wimmer,AUT,DF,Hannover 96,25,1992,18.7,25,17,17,6,2,15,27,55.6,12,30,23,7,41,66,63,0
460,Axel Witsel,BEL,MF,Dortmund,29,1989,31.9,47,33,19,24,4,17,28,60.7,11,33,6,27,47,94,49,0
461,Marius Wolf,GER,DF|FW,Dortmund,23,1995,9.2,14,10,11,3,0,5,13,38.5,8,6,0,6,13,27,12,0
462,Jeong Woo-yeong,KOR,FW,Bayern Munich,18,1999,0.1,0,0,0,0,0,0,1,0.0,1,0,0,0,0,0,0,0
463,Bobby Wood,USA,FW|MF,Hannover 96,25,1992,13.1,13,10,2,10,1,5,8,62.5,3,2,0,2,4,17,6,0
464,Haji Wright,USA,FW,Schalke 04,20,1998,2.2,3,2,1,1,1,0,1,0.0,1,1,0,1,0,3,1,0
465,John Yeboah,GER,MF|FW,Wolfsburg,18,2000,0.6,0,0,0,0,0,0,3,0.0,3,1,0,1,1,1,0,0
466,Dan-Axel Zagadou,FRA,DF,Dortmund,19,1999,14.1,13,10,10,2,1,4,6,66.7,2,17,11,6,25,38,70,2
467,Denis Zakaria,SUI,MF,M'Gladbach,21,1996,21.8,40,21,15,24,1,12,30,40.0,18,38,9,29,26,66,20,0
468,Robin Zentner,GER,GK,Mainz 05,23,1994,10.0,0,0,0,0,0,0,1,0.0,1,0,0,0,1,1,3,0
469,Ron-Robert Zieler,GER,GK,Stuttgart,29,1989,34.0,2,1,2,0,0,1,4,25.0,3,1,0,1,1,3,19,3
470,Jean Zimmer,GER,DF|FW,Düsseldorf,24,1993,15.9,17,11,11,5,1,6,16,37.5,10,13,2,11,11,28,32,1
471,Matthias Zimmermann,GER,DF|MF,Düsseldorf,26,1992,33.9,97,64,69,24,4,45,90,50.0,45,51,18,33,67,164,90,2
472,Adam Zreľák,SVK,FW,Nürnberg,24,1994,10.5,14,9,2,11,1,5,9,55.6,4,14,2,12,2,16,13,0
473,Steven Zuber,SUI,MF|FW,Hoffenheim,26,1991,6.3,12,9,5,6,1,6,13,46.2,7,5,1,4,5,17,4,0
474,Steven Zuber,SUI,MF|FW,Stuttgart,26,1991,11.7,6,3,2,2,2,1,13,7.7,12,14,2,12,6,12,6,0
