Rk,Player,Nation,Pos,Squad,Age,Born,90s,Tackles Tkl,Tackles TklW,Tackles Def 3rd,Tackles Mid 3rd,Tackles Att 3rd,Challenges Tkl,Challenges Att,Challenges Tkl%,Challenges Lost,Blocks Blocks,Blocks Sh,Blocks Pass,Int,Tkl+Int,Clr,Err
1,Gennaro Acampora,ITA,MF|FW,Spezia,26,1994,4.9,6,4,1,4,1,2,7,28.6,5,4,1,3,4,10,4,0
2,Francesco Acerbi,ITA,DF,Lazio,32,1988,31.3,51,32,34,13,4,18,40,45.0,22,24,15,9,76,127,121,2
3,Andrea Adorante,ITA,FW,Parma,20,2000,0.1,0,0,0,0,0,0,0,,0,0,0,0,0,0,0,0
4,Lucien Agoume,FRA,MF,Spezia,18,2002,8.9,18,10,11,7,0,6,19,31.6,13,10,5,5,15,33,10,0
5,Kevin Agudelo,COL,FW,Spezia,21,1998,15.1,39,28,9,15,15,12,34,35.3,22,30,0,30,10,49,2,0
6,Jean-Daniel Akpa-Akpro,CIV,MF,Lazio,27,1992,11.7,38,25,13,22,3,8,27,29.6,19,24,6,18,18,56,13,0
7,Luis Alberto,ESP,MF,Lazio,27,1992,29.1,43,24,15,19,9,15,73,20.5,58,41,2,39,13,56,11,1
8,Bruno Alves,POR,DF,Parma,38,1981,18.1,13,10,10,3,0,7,9,77.8,2,17,12,5,26,39,81,0
9,Wisdom Amey,ITA,DF,Bologna,14,2005,0.0,0,0,0,0,0,0,0,,0,0,0,0,0,0,0,0
10,Sofyan Amrabat,MAR,MF,Fiorentina,23,1996,27.1,39,22,11,24,4,18,48,37.5,30,30,5,25,23,62,12,0
11,Djavan Anderson,NED,DF,Lazio,25,1995,0.8,0,0,0,0,0,0,1,0.0,1,1,0,1,1,1,0,0
12,Nícolas Andrade,BRA,GK,Udinese,32,1988,2.0,0,0,0,0,0,0,0,,0,0,0,0,0,0,0,0
13,Davide Angelo Ghislandi,ITA,DF,Atalanta,19,2001,0.1,0,0,0,0,0,0,0,,0,0,0,0,0,0,1,0
14,Philip Ankhrah,GHA,MF,Hellas Verona,17,2002,0.1,0,0,0,0,0,0,0,,0,1,0,1,0,0,0,0
15,Cristian Ansaldi,ARG,DF|FW,Torino,33,1986,21.6,48,33,25,14,9,24,38,63.2,14,21,7,14,16,64,38,0
16,Valentin Antov,BUL,DF,Bologna,19,2000,2.6,4,2,3,1,0,3,10,30.0,7,6,5,1,4,8,13,0
17,Nicolò Armini,ITA,DF,Lazio,19,2001,0.1,0,0,0,0,0,0,0,,0,0,0,0,0,0,0,0
18,Tolgay Arslan,GER,MF,Udinese,29,1990,20.2,52,32,24,24,4,25,54,46.3,29,22,2,20,22,74,15,1
19,Kwadwo Asamoah,GHA,DF|MF,Cagliari,31,1988,2.5,4,3,2,2,0,2,3,66.7,1,5,1,4,4,8,2,1
20,Kristoffer Askildsen,NOR,MF,Sampdoria,19,2001,1.1,0,0,0,0,0,0,0,,0,2,0,2,3,3,3,0
21,Emil Audero,ITA,GK,Sampdoria,23,1997,37.0,1,1,1,0,0,1,2,50.0,1,0,0,0,1,2,16,0
22,Tommaso Augello,ITA,DF,Sampdoria,25,1994,35.7,42,30,27,10,5,23,39,59.0,16,22,2,20,32,74,76,1
23,Kaan Ayhan,TUR,DF,Sassuolo,25,1994,8.8,15,9,8,5,2,8,13,61.5,5,9,5,4,16,31,33,0
24,Milan Badelj,CRO,MF,Genoa,31,1989,26.8,56,27,27,22,7,26,84,31.0,58,51,10,41,87,143,45,1
25,Tiemoué Bakayoko,FRA,MF,Napoli,25,1994,21.8,69,41,21,41,7,23,40,57.5,17,24,2,22,36,105,13,2
26,Keita Baldé,SEN,FW,Sampdoria,25,1995,13.3,9,6,2,6,1,4,10,40.0,6,10,1,9,0,9,3,0
27,Botond Balogh,HUN,DF,Parma,18,2002,1.8,9,7,9,0,0,2,5,40.0,3,4,3,1,2,11,8,0
28,Mattia Bani,ITA,DF,Genoa,26,1993,10.2,10,5,5,5,0,5,12,41.7,7,16,11,5,27,37,44,0
29,Mattia Bani,ITA,DF,Parma,26,1993,12.7,20,11,15,4,1,4,8,50.0,4,10,6,4,33,53,50,0
30,Antonín Barák,CZE,MF,Hellas Verona,25,1994,30.7,30,19,8,16,6,14,47,29.8,33,26,7,19,12,42,38,1
31,Federico Barba,ITA,DF,Benevento,26,1993,29.5,31,16,22,8,1,21,35,60.0,14,39,18,21,48,79,94,4
32,Nicolò Barella,ITA,MF,Inter,23,1997,32.2,58,31,23,29,6,23,72,31.9,49,29,4,25,26,84,14,0
33,Antonio Barreca,ITA,DF,Fiorentina,25,1995,0.9,1,0,0,1,0,1,1,100.0,0,0,0,0,0,1,1,0
34,Musa Barrow,GAM,FW|MF,Bologna,21,1998,32.5,26,10,8,10,8,10,25,40.0,15,37,2,35,11,37,15,0
35,Paolo Bartolomei,ITA,MF,Spezia,30,1989,3.6,6,2,3,1,2,4,7,57.1,3,1,0,1,1,7,2,0
36,Daniele Baselli,ITA,MF,Torino,28,1992,4.4,12,7,3,6,3,6,10,60.0,4,2,0,2,9,21,5,0
37,Alessandro Bastoni,ITA,DF,Inter,21,1999,32.5,36,22,13,21,2,17,27,63.0,10,34,16,18,40,76,75,0
38,Simone Bastoni,ITA,DF,Spezia,23,1996,16.9,50,29,26,22,2,27,52,51.9,25,19,1,18,16,66,31,0
39,Bastos,ANG,DF,Lazio,29,1991,0.7,3,1,2,0,1,3,5,60.0,2,1,0,1,0,3,3,0
40,Rodrigo Becão,BRA,DF,Udinese,24,1996,30.9,59,33,36,20,3,27,49,55.1,22,48,27,21,68,127,94,2
41,Valon Behrami,SUI,MF,Genoa,35,1985,9.9,21,9,9,10,2,9,26,34.6,17,13,5,8,9,30,13,0
42,Andrea Belotti,ITA,FW,Torino,26,1993,32.1,30,18,4,16,10,11,35,31.4,24,27,4,23,12,42,21,0
43,Ahmad Benali,LBY,MF,Crotone,28,1992,13.5,19,11,10,9,0,11,38,28.9,27,15,2,13,6,25,15,0
44,Ismaël Bennacer,ALG,MF,Milan,22,1997,14.7,39,18,17,21,1,15,32,46.9,17,10,1,9,20,59,12,0
45,Rodrigo Bentancur,URU,MF,Juventus,23,1997,25.8,63,33,21,37,5,20,59,33.9,39,35,12,23,47,110,46,1
46,Alessandro Berardi,ITA,GK,Hellas Verona,29,1991,0.3,0,0,0,0,0,0,0,,0,0,0,0,0,0,0,0
47,Domenico Berardi,ITA,FW,Sassuolo,25,1994,27.5,42,22,17,11,14,21,62,33.9,41,23,1,22,26,68,34,0
48,Álex Berenguer,ESP,MF,Torino,25,1995,1.5,2,0,0,0,2,2,5,40.0,3,2,0,2,0,2,1,0
49,Bartosz Bereszyński,POL,DF,Sampdoria,28,1992,29.0,66,44,37,22,7,41,73,56.2,32,40,20,20,42,108,88,0
50,Federico Bernardeschi,ITA,MF|DF,Juventus,26,1994,10.8,9,4,3,5,1,4,20,20.0,16,6,2,4,14,23,7,1
51,Marco Bertini,ITA,MF,Lazio,17,2002,0.1,1,0,1,0,0,0,0,,0,0,0,0,0,1,0,0
52,Daniel Bessa,ITA,MF,Hellas Verona,27,1993,6.8,15,8,3,11,1,6,14,42.9,8,5,1,4,2,17,0,0
53,Cristiano Biraghi,ITA,DF,Fiorentina,27,1992,31.1,42,23,19,15,8,27,45,60.0,18,23,9,14,27,69,56,3
54,Davide Biraschi,ITA,DF,Genoa,26,1994,10.2,17,9,12,5,0,5,10,50.0,5,12,6,6,21,38,26,0
55,Jeremie Boga,CIV,FW|MF,Sassuolo,23,1997,19.8,11,9,5,0,6,3,11,27.3,8,10,0,10,8,19,7,0
56,Giacomo Bonaventura,ITA,MF,Fiorentina,30,1989,25.1,34,19,16,13,5,16,53,30.2,37,26,2,24,39,73,12,0
57,Federico Bonazzoli,ITA,FW,Torino,23,1997,6.3,6,4,0,4,2,2,13,15.4,11,3,0,3,2,8,3,0
58,Federico Bonazzoli,ITA,FW,Sampdoria,23,1997,1.5,0,0,0,0,0,0,0,,0,1,0,1,0,0,0,0
59,Kevin Bonifazi,ITA,DF,Udinese,24,1996,27.4,32,21,24,6,2,8,23,34.8,15,33,20,13,50,82,85,1
60,Leonardo Bonucci,ITA,DF,Juventus,33,1987,22.5,19,14,10,8,1,6,14,42.9,8,24,13,11,33,52,67,0
61,Mehdi Bourabia,MAR,MF,Sassuolo,28,1991,5.9,6,5,1,4,1,2,7,28.6,5,14,6,8,12,18,8,0
62,Edoardo Bove,ITA,MF,Roma,18,2002,0.1,0,0,0,0,0,0,1,0.0,1,0,0,0,0,0,0,0
63,Jayden Braaf,NED,FW,Udinese,17,2002,1.3,0,0,0,0,0,0,1,0.0,1,0,0,0,0,0,0,0
64,Gleison Bremer,BRA,DF,Torino,23,1997,32.6,51,34,36,14,1,21,36,58.3,15,54,21,33,70,121,142,1
65,Marcelo Brozović,CRO,MF,Inter,27,1992,28.7,54,29,23,24,7,20,61,32.8,41,43,17,26,40,94,38,0
66,Gastón Brugman,URU,MF,Parma,27,1992,18.0,35,19,18,15,2,11,44,25.0,33,33,4,29,45,80,34,0
67,Juan Brunetta,ARG,FW|MF,Parma,23,1997,5.3,2,2,0,2,0,1,6,16.7,5,5,0,5,1,3,2,0
68,Gianluigi Buffon,ITA,GK,Juventus,42,1978,8.0,0,0,0,0,0,0,0,,0,0,0,0,0,0,3,1
69,Alessandro Buongiorno,ITA,DF,Torino,21,1999,9.5,12,5,8,4,0,7,12,58.3,5,15,9,6,11,23,44,1
70,Maxime Busi,BEL,DF,Parma,20,1999,13.3,23,13,19,3,1,11,28,39.3,17,14,1,13,16,39,32,0
71,Martín Cáceres,URU,DF,Fiorentina,33,1987,24.9,28,12,16,11,1,15,35,42.9,20,20,14,6,14,42,52,1
72,Felipe Caicedo,ECU,FW,Lazio,31,1988,10.3,10,7,4,4,2,1,8,12.5,7,7,0,7,4,14,2,0
73,Arturo Calabresi,ITA,DF|FW,Bologna,24,1996,0.2,0,0,0,0,0,0,0,,0,0,0,0,0,0,2,0
74,Arturo Calabresi,ITA,DF,Cagliari,24,1996,0.2,0,0,0,0,0,0,1,0.0,1,0,0,0,0,0,0,0
75,Davide Calabria,ITA,DF,Milan,23,1996,29.4,101,64,61,32,8,54,90,60.0,36,42,9,33,37,138,82,1
76,Riccardo Calafiori,ITA,DF,Roma,18,2002,0.7,1,0,1,0,0,1,4,25.0,3,1,0,1,0,1,0,0
77,Mattia Caldara,ITA,DF,Atalanta,26,1994,1.2,1,0,0,1,0,1,1,100.0,0,3,2,1,4,5,3,0
78,Luca Caldirola,ITA,DF,Benevento,29,1991,17.5,21,13,13,6,2,10,22,45.5,12,20,15,5,20,41,56,0
79,Hakan Çalhanoğlu,TUR,MF|FW,Milan,26,1994,29.0,26,7,3,17,6,7,28,25.0,21,21,6,15,15,41,24,1
80,Fabrizio Caligara,ITA,MF|FW,Cagliari,20,2000,2.0,6,4,2,2,2,6,9,66.7,3,9,2,7,3,9,3,0
81,José Callejón,ESP,FW|MF,Fiorentina,33,1987,7.4,10,7,0,6,4,5,9,55.6,4,4,1,3,4,14,5,0
82,Drissa Camara,CIV,MF,Parma,18,2002,0.2,0,0,0,0,0,0,0,,0,0,0,0,0,0,0,0
83,Antonio Candreva,ITA,MF,Sampdoria,33,1987,27.8,28,19,17,9,2,21,53,39.6,32,24,3,21,9,37,27,1
84,Elio Capradossi,ITA,DF,Spezia,24,1996,1.0,2,1,2,0,0,2,2,100.0,0,0,0,0,1,3,5,0
85,Gianluca Caprari,ITA,MF|FW,Benevento,27,1993,20.7,16,11,5,5,6,6,31,19.4,25,19,1,18,18,34,8,0
86,Francesco Caputo,ITA,FW,Sassuolo,32,1987,18.9,0,0,0,0,0,0,2,0.0,2,4,0,4,1,1,3,0
87,Andrea Carboni,ITA,DF,Cagliari,19,2001,12.1,34,23,23,11,0,15,28,53.6,13,15,4,11,14,48,52,0
88,Giuseppe Caso,ITA,DF|FW,Genoa,21,1998,0.6,0,0,0,0,0,0,0,,0,0,0,0,0,0,0,0
89,Francesco Cassata,ITA,DF|FW,Genoa,23,1997,2.5,7,6,7,0,0,4,7,57.1,3,0,0,0,3,10,1,0
90,Samu Castillejo,ESP,FW,Milan,25,1995,13.1,24,12,9,14,1,14,40,35.0,26,21,0,21,6,30,9,0
91,Gaetano Castrovilli,ITA,MF,Fiorentina,23,1997,25.9,33,19,15,11,7,11,42,26.2,31,25,2,23,34,67,14,0
92,Danilo Cataldi,ITA,MF,Lazio,25,1994,6.3,7,2,1,5,1,4,18,22.2,14,3,1,2,9,16,7,0
93,Federico Ceccherini,ITA,DF,Hellas Verona,28,1992,19.3,16,12,10,6,0,2,7,28.6,5,15,8,7,40,56,60,0
94,Federico Ceccherini,ITA,DF,Fiorentina,28,1992,3.0,4,1,1,3,0,1,1,100.0,0,6,5,1,7,11,15,0
95,Luca Ceppitelli,ITA,DF,Cagliari,30,1989,16.3,25,19,13,10,2,14,26,53.8,12,23,12,11,25,50,58,1
96,Alberto Cerri,ITA,FW,Cagliari,24,1996,4.1,3,2,0,2,1,0,5,0.0,5,4,2,2,2,5,6,0
97,Julian Chabot,GER,DF,Spezia,22,1998,18.4,48,34,28,16,4,23,37,62.2,14,25,13,12,37,85,43,1
98,Giorgio Chiellini,ITA,DF,Juventus,35,1984,15.4,12,9,9,3,0,5,11,45.5,6,18,13,5,27,39,56,0
99,Federico Chiesa,ITA,DF,Fiorentina,22,1997,2.7,6,2,2,2,2,3,8,37.5,5,3,1,2,1,7,3,0
100,Federico Chiesa,ITA,MF|DF,Juventus,22,1997,24.6,47,26,21,14,12,19,50,38.0,31,23,1,22,12,59,16,0
101,Vlad Chiricheș,ROU,DF,Sassuolo,30,1989,20.4,38,23,34,3,1,21,35,60.0,14,31,21,10,50,88,59,2
102,Luca Cigarini,ITA,MF,Crotone,34,1986,10.3,26,14,11,12,3,12,28,42.9,16,10,1,9,12,38,9,0
103,Antonio Cioffi,ITA,FW,Napoli,17,2002,0.1,0,0,0,0,0,0,0,,0,1,0,1,1,1,0,0
104,Ebrima Colley,GAM,MF|FW,Hellas Verona,20,2000,8.2,11,4,2,6,3,3,11,27.3,8,6,0,6,6,17,1,0
105,Omar Colley,GAM,DF,Sampdoria,27,1992,28.8,28,16,19,8,1,13,23,56.5,10,43,29,14,68,96,133,1
106,Simone Colombi,ITA,GK,Parma,29,1991,2.0,0,0,0,0,0,0,0,,0,0,0,0,0,0,2,0
107,Lorenzo Colombo,ITA,FW,Milan,18,2002,1.0,2,1,1,1,0,0,3,0.0,3,0,0,0,0,2,3,0
108,Andrea Consigli,ITA,GK,Sassuolo,33,1987,37.0,2,2,2,0,0,2,2,100.0,0,0,0,0,0,2,14,4
109,Andrea Conti,ITA,DF,Milan,26,1994,0.3,1,1,1,0,0,0,1,0.0,1,0,0,0,1,2,0,0
110,Andrea Conti,ITA,DF,Parma,26,1994,9.0,21,10,16,4,1,13,26,50.0,13,13,4,9,16,37,23,0
111,Alex Cordaz,ITA,GK,Crotone,37,1983,36.0,0,0,0,0,0,0,0,,0,0,0,0,1,1,7,2
112,Andreas Cornelius,DEN,FW,Parma,27,1993,21.1,11,4,1,5,5,2,12,16.7,10,9,2,7,1,12,25,1
113,Joaquín Correa,ARG,FW,Lazio,25,1994,21.5,21,12,6,11,4,7,25,28.0,18,14,0,14,7,28,12,0
114,Félix Correia,POR,MF,Juventus,19,2001,0.1,0,0,0,0,0,0,0,,0,0,0,0,0,0,1,0
115,Douglas Costa,BRA,MF|FW,Juventus,29,1990,0.5,1,0,1,0,0,1,3,33.3,2,0,0,0,0,1,0,0
116,Angelo da Costa Júnior,BRA,GK,Bologna,36,1983,6.0,0,0,0,0,0,0,0,,0,0,0,0,0,0,2,3
117,Mamadou Coulibaly,SEN,MF,Udinese,21,1999,2.0,10,8,5,5,0,0,0,,0,2,0,2,1,11,0,0
118,Alessio Cragno,ITA,GK,Cagliari,26,1994,34.0,0,0,0,0,0,0,1,0.0,1,0,0,0,1,1,10,0
119,Gian Crespi,ITA,GK,Crotone,19,2001,1.0,0,0,0,0,0,0,0,,0,0,0,0,0,0,0,0
120,Domenico Criscito,ITA,DF,Genoa,33,1986,19.2,43,22,29,11,3,22,39,56.4,17,27,14,13,44,87,51,0
121,Bryan Cristante,ITA,DF|MF,Roma,25,1995,23.9,27,20,10,14,3,10,28,35.7,18,21,7,14,40,67,61,1
122,Giovanni Crociata,ITA,DF,Crotone,22,1997,0.3,1,0,0,1,0,0,1,0.0,1,1,0,1,0,1,0,0
123,Juan Cuadrado,COL,DF|MF,Juventus,32,1988,24.2,43,25,22,15,6,29,60,48.3,31,16,2,14,43,86,22,2
124,Giuseppe Cuomo,ITA,DF,Crotone,22,1998,8.9,26,19,17,9,0,9,14,64.3,5,10,2,8,18,44,19,1
125,Patrick Cutrone,ITA,FW,Fiorentina,22,1998,2.2,4,3,1,2,1,1,2,50.0,1,1,0,1,1,5,0,0
126,Wylan Cyprien,FRA,MF,Parma,25,1995,4.6,9,4,5,3,1,2,4,50.0,2,13,8,5,5,14,6,1
127,Lennart-Marten Czyborra,GER,DF,Genoa,21,1999,13.0,19,10,7,7,5,11,19,57.9,8,6,1,5,17,36,27,0
128,Danilo D'Ambrosio,ITA,DF,Inter,31,1988,7.8,15,9,6,7,2,6,15,40.0,9,9,7,2,4,19,15,0
129,Bryan Dabo,BFA,MF,Benevento,28,1992,12.4,11,8,5,3,3,5,16,31.3,11,7,1,6,13,24,16,0
130,Diogo Dalot,POR,DF,Milan,21,1999,12.1,32,17,23,6,3,17,34,50.0,17,18,5,13,25,57,42,0
131,Mikkel Damsgaard,DEN,MF|FW,Sampdoria,20,2000,19.7,42,21,14,20,8,22,70,31.4,48,40,4,36,24,66,17,0
132,Danilo,BRA,DF|MF,Juventus,29,1991,32.4,62,31,37,16,9,35,66,53.0,31,32,12,20,66,128,68,2
133,Andrea Danzi,ITA,DF,Hellas Verona,21,1999,1.2,0,0,0,0,0,0,1,0.0,1,0,0,0,3,3,1,0
134,Ebrima Darboe,GAM,MF,Roma,19,2001,3.6,5,2,3,1,1,3,10,30.0,7,3,0,3,8,13,0,1
135,Matteo Darmian,ITA,DF,Parma,30,1989,2.3,6,5,3,3,0,4,7,57.1,3,2,0,2,6,12,7,0
136,Matteo Darmian,ITA,DF,Inter,30,1989,12.9,30,16,12,7,11,16,28,57.1,12,9,2,7,17,47,35,0
137,Paweł Dawidowicz,POL,DF,Hellas Verona,25,1995,20.7,42,28,30,10,2,14,24,58.3,10,28,19,9,27,69,62,1
138,Sebastien De Maio,FRA,DF,Udinese,33,1987,9.5,15,10,6,9,0,4,5,80.0,1,16,9,7,18,33,41,0
139,Rodrigo De Paul,ARG,MF,Udinese,26,1994,35.6,41,24,17,22,2,15,60,25.0,45,32,1,31,17,58,20,1
140,Mattia De Sciglio,ITA,DF,Juventus,27,1992,0.3,0,0,0,0,0,0,0,,0,0,0,0,0,0,1,0
141,Lorenzo De Silvestri,ITA,DF,Bologna,32,1988,23.8,34,24,18,13,3,16,37,43.2,21,37,10,27,30,64,62,3
142,Grégoire Defrel,MTQ,MF|FW,Sassuolo,29,1991,14.8,13,8,5,5,3,5,13,38.5,8,9,0,9,7,20,5,0
143,Alessandro Deiola,ITA,MF,Spezia,24,1995,4.0,6,3,2,3,1,5,13,38.5,8,3,1,2,3,9,1,0
144,Alessandro Deiola,ITA,MF,Cagliari,24,1995,6.8,13,5,5,4,4,8,23,34.8,15,7,2,5,11,24,11,0
145,Lorenzo Del Pinto,ITA,MF,Benevento,30,1990,0.1,0,0,0,0,0,0,2,0.0,2,0,0,0,0,0,0,0
146,Cristian Dell'Orco,ITA,DF,Spezia,26,1994,2.9,1,0,1,0,0,1,3,33.3,2,8,5,3,7,8,9,1
147,Merih Demiral,TUR,DF,Juventus,22,1998,10.4,12,9,8,4,0,5,13,38.5,8,16,9,7,21,33,40,0
148,Diego Demme,GER,MF,Napoli,28,1991,17.7,56,32,26,22,8,23,63,36.5,40,14,1,13,11,67,15,1
149,Stefano Denswil,NED,DF,Bologna,27,1993,1.3,2,1,1,1,0,0,1,0.0,1,1,0,1,1,3,1,0
150,Fabio Depaoli,ITA,DF,Benevento,23,1997,12.4,25,13,15,6,4,15,32,46.9,17,16,4,12,12,37,38,0
151,Fabio Depaoli,ITA,MF,Sampdoria,23,1997,0.9,1,0,0,1,0,0,2,0.0,2,0,0,0,1,2,1,0
152,Fabio Depaoli,ITA,DF,Atalanta,23,1997,2.1,3,2,0,1,2,1,2,50.0,1,4,0,4,3,6,2,0
153,Kastriot Dermaku,ALB,DF|MF,Parma,28,1992,1.1,1,1,1,0,0,0,0,,0,2,1,1,2,3,8,0
154,Kiril Despodov,BUL,FW,Cagliari,23,1996,0.1,1,1,0,1,0,1,1,100.0,0,0,0,0,0,1,0,0
155,Mattia Destro,ITA,FW,Genoa,29,1991,17.8,6,3,0,3,3,2,9,22.2,7,11,0,11,4,10,8,0
156,Gerard Deulofeu,ESP,FW|MF,Udinese,26,1994,6.6,2,2,1,1,0,2,12,16.7,10,2,0,2,3,5,0,0
157,Jacopo Dezi,ITA,FW|MF,Parma,28,1992,0.9,4,3,0,2,2,3,6,50.0,3,2,0,2,0,4,0,0
158,Samuel Di Carmine,ITA,FW,Hellas Verona,31,1988,5.6,1,2,0,1,0,0,3,0.0,3,1,0,1,0,1,5,0
159,Samuel Di Carmine,ITA,FW,Crotone,31,1988,5.3,2,2,1,0,1,1,3,33.3,2,2,0,2,0,2,5,0
160,Giovanni Di Lorenzo,ITA,DF,Napoli,26,1993,36.0,79,50,54,21,4,43,75,57.3,32,37,13,24,35,114,64,1
161,Alessandro Di Pardo,ITA,FW|DF,Juventus,21,1999,0.2,0,0,0,0,0,0,0,,0,1,1,0,0,0,0,0
162,Giuseppe Di Serio,ITA,FW|MF,Benevento,19,2001,3.2,2,2,1,1,0,0,4,0.0,4,5,0,5,0,2,4,0
163,Amad Diallo,CIV,MF,Atalanta,18,2002,0.2,0,0,0,0,0,0,0,,0,0,0,0,0,0,0,0
164,Amadou Diambo,GHA,FW,Benevento,19,2001,0.0,0,0,0,0,0,0,0,,0,0,0,0,0,0,0,0
165,Amadou Diawara,GUI,MF,Roma,23,1997,7.3,10,8,4,6,0,2,8,25.0,6,11,2,9,12,22,4,0
166,Brahim Díaz,ESP,MF|FW,Milan,20,1999,13.6,18,10,7,7,4,10,23,43.5,13,10,0,10,2,20,2,0
167,Daan Dierckx,BEL,DF,Parma,17,2003,5.2,5,4,5,0,0,3,5,60.0,2,10,6,4,13,18,21,0
168,Mitchell Dijks,NED,DF,Bologna,27,1993,16.5,21,14,15,5,1,12,21,57.1,9,17,2,15,17,38,35,0
169,Federico Dimarco,ITA,DF,Hellas Verona,22,1997,29.0,32,19,23,7,2,13,28,46.4,15,18,9,9,47,79,50,1
170,Koffi Djidji,CIV,DF,Crotone,27,1992,16.9,39,28,30,8,1,10,20,50.0,10,35,20,15,28,67,73,0
171,Berat Djimsiti,ALB,DF,Atalanta,27,1993,29.2,41,29,27,12,2,17,34,50.0,17,34,20,14,62,103,89,1
172,Nicolás Domínguez,ARG,MF,Bologna,22,1998,13.9,48,28,26,17,5,15,37,40.5,22,26,7,19,24,72,20,0
173,Gianluigi Donnarumma,ITA,GK,Milan,21,1999,37.0,0,0,0,0,0,0,1,0.0,1,1,0,1,1,1,23,2
174,Bartłomiej Drągowski,POL,GK,Fiorentina,22,1997,35.0,1,0,1,0,0,1,1,100.0,0,0,0,0,1,2,13,1
175,Denis Drăguș,ROU,FW|MF,Crotone,21,1999,2.0,3,1,0,0,3,0,4,0.0,4,4,0,4,1,4,0,0
176,Radu Drăgușin,ROU,DF,Juventus,18,2002,0.0,0,0,0,0,0,0,0,,0,0,0,0,0,0,0,0
177,Léo Duarte,BRA,DF,Milan,24,1996,0.2,1,1,0,1,0,0,0,,0,0,0,0,1,2,0,0
178,Alfred Duncan,GHA,MF,Fiorentina,27,1993,1.8,3,0,1,1,1,0,2,0.0,2,2,0,2,2,5,0,0
179,Alfred Duncan,GHA,MF,Cagliari,27,1993,11.9,18,10,8,9,1,4,21,19.0,17,8,0,8,16,34,8,1
180,Paulo Dybala,ARG,FW,Juventus,26,1993,12.6,14,8,3,4,7,2,14,14.3,12,15,0,15,1,15,1,0
181,Edin Džeko,BIH,FW,Roma,34,1986,20.3,8,6,2,3,3,3,9,33.3,6,9,4,5,1,9,11,0
182,Steeve-Mike Ebongue,FRA,MF,Genoa,19,2001,0.6,2,1,1,0,1,0,3,0.0,3,1,0,1,0,2,0,0
183,Simone Edera,ITA,DF|MF,Torino,23,1997,0.6,3,1,2,1,0,3,4,75.0,1,0,0,0,1,4,1,0
184,Albin Ekdal,SWE,MF,Sampdoria,31,1989,25.5,56,29,21,32,3,23,65,35.4,42,31,12,19,49,105,35,0
185,Elif Elmas,MKD,MF|FW,Napoli,20,1999,8.2,15,4,3,6,6,7,12,58.3,5,11,1,10,2,17,10,0
186,Alan Empereur,BRA,DF,Hellas Verona,26,1994,2.4,0,0,0,0,0,0,0,,0,1,1,0,6,6,7,1
187,Christian Eriksen,DEN,MF,Inter,28,1992,15.4,12,6,6,4,2,7,20,35.0,13,16,1,15,9,21,13,1
188,Martin Erlic,CRO,DF,Spezia,22,1998,20.0,23,14,16,6,1,11,20,55.0,9,22,16,6,41,64,71,2
189,Gonzalo Escalante,ARG,MF,Lazio,27,1993,8.1,26,13,11,14,1,8,28,28.6,20,10,3,7,19,45,13,0
190,Nahuel Estévez,ARG,MF,Spezia,24,1995,19.6,13,5,4,6,3,5,32,15.6,27,23,5,18,20,33,22,1
191,Valentin Eysseric,FRA,MF|FW,Fiorentina,28,1992,8.1,14,8,6,7,1,5,11,45.5,6,11,0,11,7,21,8,0
192,Nicolò Fagioli,ITA,MF,Juventus,19,2001,0.2,0,0,0,0,0,0,0,,0,0,0,0,0,0,1,0
193,Iago Falque,ESP,MF|FW,Benevento,30,1990,4.0,4,2,2,2,0,1,6,16.7,5,4,1,3,0,4,1,0
194,Andri Fannar Baldursson,ISL,MF,Bologna,18,2002,2.4,6,6,1,2,3,1,3,33.3,2,3,1,2,3,9,7,0
195,Paolo Faragò,ITA,DF,Bologna,27,1993,0.3,1,1,1,0,0,1,2,50.0,1,1,0,1,0,1,0,0
196,Paolo Faragò,ITA,DF,Cagliari,27,1993,4.1,13,9,10,3,0,9,20,45.0,11,3,2,1,6,19,15,0
197,Davide Faraoni,ITA,DF,Hellas Verona,28,1991,32.1,62,33,36,19,7,28,51,54.9,23,48,17,31,49,111,83,1
198,Mohamed Fares,ALG,DF,Lazio,24,1996,12.7,20,15,9,7,4,11,19,57.9,8,14,1,13,16,36,21,0
199,Diego Farias,BRA,FW,Spezia,30,1990,16.8,9,5,4,1,4,4,21,19.0,17,12,0,12,13,22,3,0
200,Andrea Favilli,ITA,FW,Hellas Verona,23,1997,3.8,3,1,0,1,2,2,3,66.7,1,2,0,2,0,3,2,0
201,Federico Fazio,ARG,DF,Roma,33,1987,4.5,3,2,3,0,0,3,4,75.0,1,3,3,0,7,10,18,1
202,Luiz Felipe,ITA,DF,Lazio,23,1997,10.1,32,20,19,11,2,16,24,66.7,8,20,9,11,21,53,29,1
203,Alex Ferrari,ITA,DF,Sampdoria,26,1994,9.8,27,15,16,9,2,15,24,62.5,9,18,6,12,23,50,26,0
204,Salvador Ferrer,ESP,DF,Spezia,22,1998,13.2,20,10,10,8,2,8,22,36.4,14,13,4,9,24,44,37,1
205,Marco Festa,ITA,GK,Crotone,28,1992,1.0,0,0,0,0,0,0,0,,0,0,0,0,0,0,0,0
206,Fernando Forestieri,ITA,FW|MF,Udinese,30,1990,6.1,9,7,4,4,1,3,7,42.9,4,7,0,7,2,11,0,0
207,Daam Foulon,BEL,DF,Benevento,21,1999,11.3,26,15,21,5,0,16,28,57.1,12,12,3,9,14,40,34,0
208,Gianluca Frabotta,ITA,DF|MF,Juventus,21,1999,7.7,7,4,5,0,2,5,12,41.7,7,9,1,8,14,21,15,0
209,Remo Freuler,SUI,MF,Atalanta,28,1992,30.1,63,39,17,38,8,32,76,42.1,44,52,4,48,39,102,27,2
210,Daniel Fuzato,BRA,GK,Roma,23,1997,5.0,0,0,0,0,0,0,0,,0,1,0,1,0,0,1,1
211,Matteo Gabbia,ITA,DF,Milan,20,1999,6.2,9,5,3,6,0,2,2,100.0,0,8,6,2,3,12,21,0
212,Manolo Gabbiadini,ITA,FW,Sampdoria,28,1991,9.7,2,2,0,2,0,0,1,0.0,1,3,1,2,3,5,5,0
213,Roberto Gagliardini,ITA,MF,Inter,26,1994,13.7,30,17,17,8,5,5,28,17.9,23,15,3,12,19,49,16,0
214,Riccardo Gagliolo,SWE,DF,Parma,30,1990,21.7,45,18,35,8,2,28,45,62.2,17,34,7,27,36,81,64,1
215,Adolfo Gaich,ARG,FW,Benevento,21,1999,8.5,9,4,1,7,1,1,13,7.7,12,4,0,4,2,11,4,0
216,Andrey Galabinov,BUL,FW,Spezia,31,1988,4.8,2,1,1,1,0,1,3,33.3,2,2,0,2,0,2,5,0
217,Manuel Gasparini,ITA,GK,Udinese,18,2002,0.0,0,0,0,0,0,0,0,,0,0,0,0,0,0,0,0
218,Gervinho,CIV,FW,Parma,33,1987,22.5,5,1,2,2,1,1,14,7.1,13,11,1,10,10,15,3,0
219,Paolo Ghiglione,ITA,DF|MF,Genoa,23,1997,15.1,27,15,17,8,2,13,28,46.4,15,14,2,12,13,40,25,0
220,Faouzi Ghoulam,ALG,DF|FW,Napoli,29,1991,3.2,6,5,3,2,1,0,1,0.0,1,4,2,2,3,9,1,0
221,Kamil Glik,POL,DF,Benevento,32,1988,35.6,44,24,33,10,1,25,53,47.2,28,37,31,6,62,106,153,0
222,Diego Godín,URU,DF,Cagliari,34,1986,27.9,60,32,51,9,0,24,39,61.5,15,41,24,17,56,116,117,0
223,Amer Gojak,BIH,MF|FW,Torino,23,1997,5.3,1,0,1,0,0,1,7,14.3,6,5,0,5,3,4,1,0
224,Edoardo Goldaniga,ITA,DF,Genoa,26,1993,20.6,28,18,21,7,0,14,23,60.9,9,17,7,10,38,66,62,1
225,Vladimir Golemić,SVN,DF,Crotone,29,1991,26.0,33,16,17,13,3,14,19,73.7,5,38,26,12,40,73,97,2
226,Pierluigi Gollini,ITA,GK,Atalanta,25,1995,24.0,1,0,1,0,0,1,2,50.0,1,1,0,1,1,2,11,0
227,Tomislav Gomelt,CRO,MF,Crotone,25,1995,0.2,1,1,0,1,0,0,0,,0,0,0,0,1,2,0,0
228,Papu Gómez,ARG,MF|FW,Atalanta,32,1988,7.4,3,2,2,1,0,2,8,25.0,6,8,1,7,1,4,1,0
229,Robin Gosens,GER,DF,Atalanta,26,1994,28.0,46,35,20,15,11,17,41,41.5,24,50,7,43,41,87,34,0
230,Alberto Grassi,ITA,MF|DF,Parma,25,1995,13.1,30,11,14,13,3,8,29,27.6,21,22,9,13,26,56,32,0
231,Koray Günter,GER,DF,Hellas Verona,25,1994,19.6,20,10,10,9,1,4,9,44.4,5,27,21,6,70,90,87,0
232,Manu Gyabuaa,ITA,MF,Atalanta,18,2001,0.0,0,0,0,0,0,0,0,,0,0,0,0,0,0,0,0
233,Emmanuel Gyasi,GHA,FW,Spezia,26,1994,31.7,30,16,16,10,4,9,31,29.0,22,13,2,11,14,44,8,0
234,Achraf Hakimi,MAR,DF,Inter,21,1998,29.6,53,32,23,19,11,23,48,47.9,25,31,1,30,22,75,23,1
235,Samir Handanović,SVN,GK,Inter,36,1984,36.0,1,0,1,0,0,1,1,100.0,0,0,0,0,0,1,6,3
236,Lukáš Haraslín,SVK,FW|MF,Sassuolo,24,1996,3.7,8,4,2,5,1,2,5,40.0,3,1,0,1,0,8,2,0
237,Hans Hateboer,NED,DF,Atalanta,26,1994,19.6,28,17,12,14,2,13,23,56.5,10,8,1,7,17,45,9,0
238,Eduardo Henrique,BRA,MF,Crotone,25,1995,10.3,5,2,1,4,0,3,12,25.0,9,6,1,5,7,12,7,1
239,Theo Hernández,FRA,DF,Milan,22,1997,32.6,48,29,22,21,5,19,38,50.0,19,29,6,23,34,82,64,5
240,Hernani,BRA,MF,Parma,26,1994,24.3,51,25,21,27,3,29,66,43.9,37,35,4,31,31,82,40,1
241,Përparim Hetemaj,FIN,MF,Benevento,33,1986,24.6,44,27,21,18,5,26,61,42.6,35,41,5,36,22,66,24,1
242,Aaron Hickey,SCO,DF,Bologna,18,2002,8.4,12,8,10,2,0,7,17,41.2,10,6,1,5,15,27,15,1
243,Wesley Hoedt,NED,DF,Lazio,26,1994,10.6,22,16,18,4,0,10,17,58.8,7,9,5,4,17,39,48,1
244,Elseid Hysaj,ALB,DF,Napoli,26,1994,19.6,29,17,16,11,2,17,33,51.5,16,18,4,14,30,59,52,0
245,Simone Iacoponi,ITA,DF,Parma,33,1987,13.3,22,12,16,5,1,13,26,50.0,13,9,4,5,11,33,42,1
246,Roger Ibanez,BRA,DF,Roma,21,1998,26.6,59,37,28,25,6,25,45,55.6,20,38,17,21,68,127,78,3
247,Zlatan Ibrahimović,SWE,FW,Milan,38,1981,16.6,5,4,0,4,1,3,6,50.0,3,5,3,2,6,11,27,1
248,Igor,BRA,DF,Fiorentina,22,1998,13.0,15,9,9,6,0,7,12,58.3,5,17,9,8,23,38,34,0
249,Ivan Ilić,SRB,MF,Hellas Verona,19,2001,20.4,26,14,11,11,4,7,21,33.3,14,17,5,12,27,53,26,0
250,Josip Iličić,SVN,MF|FW,Atalanta,32,1988,17.0,9,4,1,5,3,5,21,23.8,16,12,0,12,2,11,0,1
251,Ciro Immobile,ITA,FW,Lazio,30,1990,31.7,14,13,4,6,4,7,22,31.8,15,13,1,12,6,20,9,0
252,Riccardo Improta,ITA,DF|MF,Benevento,26,1993,25.9,39,23,25,8,6,21,45,46.7,24,23,4,19,28,67,47,0
253,Roberto Inglese,ITA,FW,Parma,28,1991,6.4,5,2,1,2,2,2,11,18.2,9,10,0,10,0,5,3,0
254,Lorenzo Insigne,ITA,FW,Napoli,29,1991,31.8,26,18,8,12,6,13,72,18.1,59,30,1,29,37,63,6,1
255,Roberto Insigne,ITA,MF|FW,Benevento,26,1994,17.8,16,10,8,3,5,7,27,25.9,20,10,0,10,7,23,9,0
256,Artur Ioniță,MDA,MF,Benevento,29,1990,31.5,47,22,11,31,5,17,63,27.0,46,38,14,24,19,66,28,0
257,Ardian Ismajli,ALB,DF,Spezia,23,1996,14.4,19,9,10,8,1,8,13,61.5,5,10,7,3,23,42,52,1
258,Armando Izzo,ITA,DF,Torino,28,1992,22.3,30,16,13,13,4,13,33,39.4,20,22,9,13,53,83,62,0
259,Mato Jajalo,BIH,MF,Udinese,32,1988,0.4,1,1,1,0,0,1,1,100.0,0,1,0,1,2,3,0,0
260,Jakub Jankto,CZE,MF,Sampdoria,24,1996,26.8,28,17,14,7,7,11,35,31.4,24,16,1,15,24,52,34,0
261,Juan Jesus,BRA,DF,Roma,29,1991,1.7,3,1,2,1,0,2,4,50.0,2,1,0,1,2,5,5,0
262,Hamed Junior Traorè,CIV,MF|FW,Sassuolo,20,2000,19.9,29,17,10,10,9,14,35,40.0,21,27,3,24,18,47,9,0
263,Musa Juwara,GAM,MF|DF,Bologna,18,2001,0.5,2,2,2,0,0,1,3,33.3,2,1,0,1,0,2,0,0
264,Nikola Kalinić,CRO,FW,Hellas Verona,32,1988,11.8,5,1,2,2,1,0,3,0.0,3,6,0,6,1,6,7,0
265,Yayah Kallon,SLE,FW,Genoa,19,2001,0.5,0,0,0,0,0,0,0,,0,0,0,0,0,0,0,0
266,Pierre Kalulu,FRA,DF,Milan,20,2000,8.1,18,14,11,6,1,10,14,71.4,4,9,3,6,19,37,20,0
267,Yann Karamoh,FRA,FW|MF,Parma,22,1998,14.4,27,17,8,12,7,11,31,35.5,20,6,0,6,4,31,11,0
268,Isaac Karamoko,FRA,DF,Sassuolo,18,2002,0.0,1,0,0,0,1,1,1,100.0,0,0,0,0,0,1,0,0
269,Augustus Kargbo,SLE,FW,Crotone,20,1999,0.4,0,0,0,0,0,0,0,,0,0,0,0,0,0,0,0
270,Rick Karsdorp,NED,DF,Roma,25,1995,28.3,36,23,19,12,5,21,48,43.8,27,18,1,17,30,66,32,0
271,Franck Kessié,CIV,MF,Milan,23,1996,35.8,53,30,28,19,6,20,38,52.6,18,47,15,32,46,99,51,0
272,Omar Khailoti,ITA,DF,Bologna,18,2001,0.3,0,0,0,0,0,0,0,,0,2,0,2,1,1,0,0
273,Simon Kjær,DEN,DF,Milan,31,1989,26.6,45,26,23,20,2,18,30,60.0,12,42,26,16,42,87,125,0
274,Ragnar Klavan,EST,DF,Cagliari,34,1985,8.6,15,9,9,5,1,7,11,63.6,4,9,4,5,8,23,34,0
275,Justin Kluivert,NED,MF,Roma,21,1999,0.2,0,0,0,0,0,0,0,,0,0,0,0,0,0,0,0
276,Aleksandr Kokorin,RUS,FW|MF,Fiorentina,29,1991,1.0,1,0,0,1,0,0,1,0.0,1,1,0,1,0,1,0,0
277,Aleksandar Kolarov,SRB,DF,Inter,34,1985,4.3,4,4,0,4,0,1,2,50.0,1,2,0,2,7,11,8,0
278,Márk Kosznovszky,HUN,MF,Parma,18,2002,1.0,2,2,1,1,0,1,4,25.0,3,2,0,2,1,3,1,0
279,Christian Kouamé,CIV,FW,Fiorentina,22,1997,11.1,9,4,2,4,3,4,12,33.3,8,9,1,8,5,14,4,0
280,Kalidou Koulibaly,SEN,DF,Napoli,29,1991,24.5,36,24,25,7,4,19,32,59.4,13,46,26,20,29,65,64,2
281,Viktor Kovalenko,UKR,FW,Atalanta,24,1996,0.0,0,0,0,0,0,0,0,,0,0,0,0,0,0,1,0
282,Rade Krunić,BIH,MF|FW,Milan,26,1993,8.0,15,12,6,6,3,7,17,41.2,10,12,2,10,10,25,9,0
283,Juraj Kucka,SVK,MF|FW,Parma,33,1987,25.9,67,36,21,37,9,26,74,35.1,48,25,3,22,28,95,25,0
284,Dejan Kulusevski,SWE,MF|FW,Juventus,20,2000,21.4,33,19,12,10,11,14,43,32.6,29,22,0,22,9,42,2,1
285,Marash Kumbulla,ALB,DF,Roma,20,2000,15.1,16,11,8,7,1,5,17,29.4,12,12,5,7,24,40,38,1
286,Jasmin Kurtić,SVN,MF,Parma,31,1989,30.4,46,28,22,21,3,21,70,30.0,49,22,2,20,33,79,57,1
287,Giorgos Kyriakopoulos,GRE,DF,Sassuolo,24,1996,16.2,35,18,17,12,6,8,28,28.6,20,16,5,11,15,50,42,0
288,Antonino La Gumina,ITA,FW,Sampdoria,24,1996,3.8,3,2,0,1,2,0,3,0.0,3,5,1,4,3,6,5,0
289,Sam Lammers,NED,FW|MF,Atalanta,23,1997,3.2,2,0,0,2,0,0,6,0.0,6,0,0,0,0,2,3,0
290,Gianluca Lapadula,PER,FW,Benevento,30,1990,28.5,22,12,3,13,6,6,25,24.0,19,18,3,15,5,27,16,0
291,Danilo Larangeira,BRA,DF,Bologna,36,1984,34.8,33,24,23,10,0,8,29,27.6,21,58,36,22,51,84,127,2
292,Kevin Lasagna,ITA,FW,Udinese,27,1992,12.3,6,1,2,3,1,3,14,21.4,11,11,0,11,6,12,7,0
293,Kevin Lasagna,ITA,FW,Hellas Verona,27,1992,14.1,7,3,0,5,2,1,5,20.0,4,12,1,11,1,8,11,0
294,Vincent Laurini,FRA,DF,Parma,31,1989,9.7,16,11,8,6,2,7,9,77.8,2,8,4,4,17,33,22,1
295,Darko Lazović,SRB,DF|MF,Hellas Verona,29,1990,27.8,29,17,8,17,4,20,42,47.6,22,17,7,10,20,49,29,0
296,Manuel Lazzari,ITA,DF,Lazio,26,1993,29.0,24,14,15,4,5,14,39,35.9,25,22,3,19,18,42,28,0
297,Rafael Leão,POR,FW,Milan,21,1999,21.4,13,6,4,7,2,6,15,40.0,9,17,0,17,4,17,14,1
298,Lucas Leiva,BRA,MF,Lazio,33,1987,23.7,68,32,38,28,2,30,86,34.9,56,21,0,21,57,125,21,0
299,Lukas Lerager,DEN,MF,Genoa,27,1993,12.9,24,13,14,9,1,11,30,36.7,19,13,3,10,14,38,25,1
300,Mehdi Léris,ALG,DF|MF,Sampdoria,22,1998,4.3,11,5,6,4,1,6,16,37.5,10,12,2,10,12,23,15,0
301,Karlo Letica,CRO,GK,Sampdoria,23,1997,1.0,0,0,0,0,0,0,0,,0,0,0,0,0,0,2,0
302,Gaetano Letizia,ITA,DF,Benevento,30,1990,17.4,36,25,19,13,4,17,36,47.2,19,15,3,12,20,56,42,1
303,Matthijs de Ligt,NED,DF,Juventus,20,1999,24.7,37,19,20,16,1,18,28,64.3,10,42,21,21,31,68,64,0
304,Karol Linetty,POL,MF,Torino,25,1995,20.4,38,28,13,19,6,16,45,35.6,29,19,5,14,15,53,7,0
305,Pol Lirola,ESP,DF|FW,Fiorentina,22,1997,5.5,13,8,8,2,3,6,12,50.0,6,6,3,3,6,19,9,0
306,Fernando Llorente,ESP,FW,Udinese,35,1985,7.9,4,1,2,2,0,2,5,40.0,3,3,0,3,2,6,17,0
307,Fernando Llorente,ESP,FW|MF,Napoli,35,1985,0.6,0,0,0,0,0,0,0,,0,0,0,0,0,0,0,0
308,Stanislav Lobotka,SVK,MF,Napoli,25,1994,1.7,1,1,0,1,0,0,1,0.0,1,1,1,0,0,1,1,1
309,Manuel Locatelli,ITA,MF,Sassuolo,22,1998,32.0,81,47,43,28,10,29,56,51.8,27,35,15,20,51,132,65,1
310,Maxime Lopez,FRA,MF,Sassuolo,22,1997,20.7,24,13,15,6,3,14,41,34.1,27,9,0,9,16,40,10,1
311,Pau López,ESP,GK,Roma,25,1994,20.2,2,0,2,0,0,2,2,100.0,0,1,0,1,0,2,7,4
312,Matteo Lovato,ITA,DF,Hellas Verona,20,2000,15.4,21,12,14,5,2,10,21,47.6,11,20,10,10,37,58,48,1
313,Hirving Lozano,MEX,FW,Napoli,25,1995,21.8,29,18,10,13,6,10,36,27.8,26,37,1,36,18,47,14,0
314,José Luis Palomino,ARG,DF,Atalanta,30,1990,27.0,67,33,41,19,7,24,48,50.0,24,30,16,14,79,146,60,2
315,Romelu Lukaku,BEL,FW,Inter,27,1993,32.0,11,1,1,6,4,6,14,42.9,8,11,1,10,3,14,34,0
316,Saša Lukić,SRB,MF,Torino,23,1996,23.4,32,13,11,18,3,15,50,30.0,35,23,5,18,17,49,17,0
317,Senad Lulić,BIH,DF,Lazio,34,1986,8.0,14,7,6,5,3,7,15,46.7,8,10,1,9,4,18,13,0
318,Sebastiano Luperto,ITA,DF,Crotone,23,1996,20.9,38,20,28,8,2,16,27,59.3,11,17,7,10,27,65,74,1
319,Lyanco,BRA,DF,Torino,23,1997,21.8,21,14,13,6,2,8,14,57.1,6,36,26,10,46,67,76,0
320,Charalambos Lykogiannis,GRE,DF,Cagliari,26,1993,26.9,34,21,22,9,3,22,38,57.9,16,34,13,21,32,66,94,0
321,Lisandro Magallán,ARG,DF,Crotone,26,1993,24.2,54,31,28,24,2,17,42,40.5,25,29,15,14,44,98,78,1
322,Christian Maggio,ITA,DF,Benevento,38,1982,3.3,9,4,2,7,0,3,9,33.3,6,4,1,3,2,11,6,0
323,Giulio Maggiore,ITA,MF,Spezia,22,1998,24.6,61,36,26,28,7,21,53,39.6,32,33,6,27,19,80,25,1
324,Francesco Magnanelli,ITA,MF,Sassuolo,35,1984,4.9,7,5,2,5,0,3,10,30.0,7,6,2,4,13,20,10,0
325,Giangiacomo Magnani,ITA,DF,Hellas Verona,24,1995,16.8,26,15,14,9,3,9,16,56.3,7,25,16,9,44,70,105,1
326,Jean-Victor Makengo,FRA,MF,Udinese,22,1998,5.8,8,7,5,3,0,3,13,23.1,10,7,1,6,5,13,7,0
327,Nikola Maksimović,SRB,DF,Napoli,28,1991,13.4,18,9,11,6,1,9,18,50.0,9,15,6,9,21,39,49,3
328,Kévin Malcuit,MAR,DF,Fiorentina,29,1991,2.3,5,3,2,2,1,0,1,0.0,1,5,0,5,3,8,6,0
329,Kévin Malcuit,MAR,FW|MF,Napoli,29,1991,0.4,2,1,2,0,0,0,1,0.0,1,0,0,0,2,4,2,0
330,Daniel Maldini,ITA,FW|DF,Milan,18,2001,0.3,1,0,0,1,0,0,2,0.0,2,0,0,0,0,1,0,0
331,Ruslan Malinovskyi,UKR,MF|FW,Atalanta,27,1993,20.8,19,8,2,13,4,8,23,34.8,15,16,1,15,2,21,4,0
332,Dennis Man,ROU,FW|MF,Parma,21,1998,7.8,12,6,6,4,2,6,21,28.6,15,5,0,5,2,14,6,0
333,Gianluca Mancini,ITA,DF,Roma,24,1996,31.7,50,29,29,19,2,18,31,58.1,13,38,18,20,72,122,77,3
334,Rolando Mandragora,ITA,MF,Udinese,23,1997,4.4,8,5,3,4,1,3,10,30.0,7,10,3,7,6,14,5,0
335,Rolando Mandragora,ITA,MF,Torino,23,1997,16.9,19,4,4,9,6,7,30,23.3,23,19,6,13,20,39,19,0
336,Mario Mandžukić,CRO,FW,Milan,34,1986,2.4,7,6,2,4,1,2,3,66.7,1,0,0,0,2,9,3,0
337,Niccolò Manfredini,ITA,GK,Benevento,32,1988,1.0,0,0,0,0,0,0,0,,0,0,0,0,0,0,2,1
338,Kostas Manolas,GRE,DF,Napoli,29,1991,25.5,31,18,24,7,0,17,24,70.8,7,22,13,9,23,54,82,2
339,Juan Manuel Ramos,URU,DF,Spezia,23,1996,3.3,5,0,3,0,2,4,7,57.1,3,1,0,1,2,7,6,0
340,Federico Marchetti,ITA,GK,Genoa,37,1983,3.7,1,0,1,0,0,1,1,100.0,0,0,0,0,0,1,2,1
341,Riccardo Marchizza,ITA,DF,Spezia,22,1998,17.3,20,11,12,5,3,12,21,57.1,9,13,4,9,11,31,27,0
342,Gian Marco Ferrari,ITA,DF,Sassuolo,28,1992,33.5,32,20,15,14,3,10,23,43.5,13,46,37,9,50,82,100,1
343,Răzvan Marin,ROU,MF,Cagliari,24,1996,32.9,54,33,26,22,6,27,53,50.9,26,29,10,19,29,83,15,0
344,Marlon,BRA,DF,Sassuolo,24,1995,19.4,19,13,13,6,0,13,18,72.2,5,23,17,6,27,46,44,2
345,Luca Marrone,ITA,DF,Crotone,30,1990,17.6,25,18,16,9,0,13,21,61.9,8,22,11,11,26,51,56,1
346,Lautaro Martínez,ARG,FW,Inter,22,1997,28.5,25,12,5,11,9,7,24,29.2,17,31,1,30,27,52,16,0
347,Lucas Martínez Quarta,ARG,DF,Fiorentina,24,1996,16.5,32,20,17,11,4,18,41,43.9,23,27,9,18,39,71,48,0
348,Adam Marušić,MNE,DF,Lazio,27,1992,33.0,38,22,22,15,1,20,40,50.0,20,38,6,32,40,78,54,0
349,Andrea Masiello,ITA,DF,Genoa,34,1986,28.5,38,22,29,6,3,23,48,47.9,25,32,13,19,53,91,107,3
350,Giuseppe Mastinu,ITA,FW,Spezia,28,1991,0.4,1,1,0,0,1,1,1,100.0,0,1,0,1,0,1,0,0
351,Ryder Matos,BRA,MF,Udinese,27,1993,0.1,0,0,0,0,0,0,0,,0,0,0,0,0,0,0,0
352,Federico Mattiello,ITA,DF,Spezia,25,1995,0.4,0,0,0,0,0,0,0,,0,0,0,0,0,0,0,0
353,Borja Mayoral,ESP,FW,Roma,23,1997,17.2,3,2,0,0,3,1,10,10.0,9,5,0,5,0,3,5,2
354,Antonio Mazzotta,ITA,DF,Crotone,30,1989,0.6,1,1,0,1,0,0,0,,0,0,0,0,0,1,1,0
355,Ibrahima Mbaye,SEN,DF,Bologna,25,1994,4.8,6,5,5,1,0,3,5,60.0,2,5,3,2,1,7,10,0
356,Weston McKennie,USA,MF,Juventus,21,1998,18.9,34,19,9,20,5,12,33,36.4,21,21,3,18,28,62,26,0
357,Gary Medel,CHI,DF|MF,Bologna,32,1987,5.7,12,9,6,5,1,4,10,40.0,6,8,6,2,7,19,10,0
358,Soualiho Meïté,FRA,MF,Torino,26,1994,10.2,11,7,6,4,1,5,16,31.3,11,18,1,17,10,21,9,1
359,Soualiho Meïté,FRA,MF,Milan,26,1994,6.5,18,10,10,6,2,8,17,47.1,9,9,2,7,8,26,16,0
360,Filippo Melegoni,ITA,MF|DF,Genoa,21,1999,4.3,7,6,2,5,0,3,6,50.0,3,5,0,5,5,12,8,0
361,Arthur Melo,BRA,MF,Juventus,23,1996,12.9,17,9,7,10,0,12,31,38.7,19,6,1,5,18,35,9,1
362,Alex Meret,ITA,GK,Napoli,23,1997,22.0,0,0,0,0,0,0,1,0.0,1,0,0,0,0,0,5,0
363,Yıldırım Mert Çetin,TUR,DF,Hellas Verona,23,1997,4.6,8,4,3,5,0,2,6,33.3,4,7,5,2,14,22,11,1
364,Dries Mertens,BEL,FW|MF,Napoli,33,1987,16.2,16,14,4,7,5,5,25,20.0,20,7,1,6,9,25,3,1
365,Junior Messias,BRA,MF|FW,Crotone,29,1991,35.7,60,35,26,24,10,22,70,31.4,48,32,12,20,35,95,40,0
366,Petar Mićin,SRB,MF,Udinese,21,1998,0.2,0,0,0,0,0,0,0,,0,0,0,0,0,0,0,0
367,Valentin Mihaila,ROU,FW|MF,Parma,20,2000,7.8,2,1,1,1,0,0,10,0.0,10,8,1,7,5,7,8,0
368,Nikola Milenković,SRB,DF,Fiorentina,22,1997,33.7,49,29,33,14,2,21,33,63.6,12,42,33,9,44,93,122,1
369,Sergej Milinković-Savić,SRB,MF,Lazio,25,1995,30.5,59,40,20,30,9,27,84,32.1,57,52,12,40,33,92,47,0
370,Vanja Milinković-Savić,SRB,GK,Torino,23,1997,5.0,1,1,1,0,0,1,1,100.0,0,0,0,0,0,1,1,3
371,Vincenzo Millico,ITA,FW|MF,Torino,19,2000,0.2,0,0,0,0,0,0,0,,0,0,0,0,0,0,0,0
372,Aleksei Miranchuk,RUS,MF|FW,Atalanta,24,1995,7.5,24,13,8,9,7,6,9,66.7,3,1,0,1,3,27,1,0
373,Antonio Mirante,ITA,GK,Roma,37,1983,12.8,0,0,0,0,0,0,1,0.0,1,1,0,1,0,0,7,2
374,Henrikh Mkhitaryan,ARM,MF|FW,Roma,31,1989,30.5,58,24,13,27,18,13,62,21.0,49,34,0,34,39,97,10,0
375,Johan Mojica,COL,DF,Atalanta,27,1992,3.3,4,4,3,1,0,2,3,66.7,1,3,0,3,7,11,6,0
376,Nahuel Molina,ARG,DF,Udinese,22,1998,20.3,27,18,13,10,4,16,42,38.1,26,26,4,22,21,48,49,1
377,Salvatore Molina,ITA,MF|DF,Crotone,28,1992,25.7,39,22,18,14,7,29,45,64.4,16,30,8,22,17,56,41,0
378,Gabriele Moncini,ITA,FW|MF,Benevento,24,1996,4.0,2,1,2,0,0,0,1,0.0,1,2,0,2,2,4,4,0
379,Cristóbal Montiel,ESP,MF|FW,Fiorentina,20,2000,0.0,0,0,0,0,0,0,1,0.0,1,0,0,0,0,0,0,0
380,Lorenzo Montipò,ITA,GK,Benevento,24,1996,37.0,0,0,0,0,0,0,0,,0,1,0,1,0,0,16,3
381,Luca Mora,ITA,MF,Spezia,32,1988,1.3,3,1,1,2,0,2,4,50.0,2,2,1,1,0,3,2,0
382,Álvaro Morata,ESP,FW,Juventus,27,1992,22.4,17,12,2,10,5,4,28,14.3,24,22,2,20,5,22,21,0
383,Raúl Moro,ESP,FW,Lazio,17,2002,0.1,0,0,0,0,0,0,1,0.0,1,0,0,0,0,0,0,0
384,Mert Müldür,TUR,DF,Sassuolo,21,1999,18.6,43,20,26,9,8,27,53,50.9,26,17,1,16,36,79,41,0
385,Luis Muriel,COL,FW,Atalanta,29,1991,16.0,20,9,4,8,8,9,26,34.6,17,17,0,17,7,27,4,0
386,Vedat Muriqi,KVX,FW,Lazio,26,1994,9.2,3,1,0,2,1,0,8,0.0,8,9,2,7,3,6,20,0
387,Nicola Murru,ITA,DF,Torino,25,1994,6.3,9,6,1,5,3,3,5,60.0,2,11,1,10,12,21,24,0
388,Mateo Musacchio,ARG,DF,Lazio,29,1990,2.5,1,1,1,0,0,0,0,,0,5,2,3,2,3,5,0
389,Mateo Musacchio,ARG,DF,Milan,29,1990,0.4,2,1,2,0,0,2,3,66.7,1,1,0,1,3,5,0,0
390,Juan Musso,ARG,GK,Udinese,26,1994,35.0,1,1,1,0,0,1,1,100.0,0,0,0,0,1,2,8,1
391,Joakim Mæhle,DEN,DF,Atalanta,23,1997,13.5,18,10,7,5,6,8,19,42.1,11,17,2,15,11,29,5,0
392,Radja Nainggolan,BEL,MF,Cagliari,32,1988,20.5,41,26,22,14,5,19,34,55.9,15,18,0,18,15,56,15,1
393,Radja Nainggolan,BEL,MF,Inter,32,1988,0.5,0,0,0,0,0,0,0,,0,0,0,0,1,1,0,0
394,Nahitan Nández,URU,MF|DF,Cagliari,24,1995,30.4,56,28,23,23,10,25,68,36.8,43,26,4,22,23,79,49,0
395,Ilija Nestorovski,MKD,FW|MF,Udinese,30,1990,7.8,6,4,2,3,1,2,13,15.4,11,5,0,5,1,7,7,0
396,Nicolas Nkoulou,CMR,DF,Torino,30,1990,15.1,14,9,11,3,0,7,12,58.3,5,28,14,14,33,47,71,1
397,Bram Nuytinck,NED,DF,Udinese,30,1990,18.2,21,15,10,9,2,13,20,65.0,7,30,17,13,25,46,77,0
398,Simeon Nwankwo,NGA,FW,Crotone,28,1992,32.7,9,2,2,6,1,3,22,13.6,19,21,5,16,6,15,51,0
399,M'Bala Nzola,ANG,FW,Spezia,23,1996,21.1,12,5,2,6,4,4,7,57.1,3,15,1,14,3,15,20,0
400,Pedro Obiang,EQG,MF,Sassuolo,28,1992,16.3,35,22,17,15,3,12,35,34.3,23,26,7,19,22,57,27,0
401,Brian Oddei,ITA,FW|MF,Sassuolo,17,2002,0.5,2,1,1,1,0,2,3,66.7,1,1,0,1,0,2,1,0
402,Stefano Okaka,ITA,FW,Udinese,30,1989,16.5,10,7,2,5,3,2,10,20.0,8,7,1,6,2,12,19,0
403,Christian Oliva,URU,MF,Cagliari,24,1996,4.3,10,4,6,3,1,6,17,35.3,11,11,1,10,8,18,7,0
404,Maximiliano Olivera,URU,DF,Fiorentina,28,1992,1.0,2,0,1,1,0,1,1,100.0,0,3,1,2,0,2,8,0
405,Jérôme Onguéné,CMR,DF,Genoa,22,1997,2.0,2,1,2,0,0,2,7,28.6,5,2,0,2,2,4,8,0
406,Riccardo Orsolini,ITA,FW|MF,Bologna,23,1997,19.5,37,18,13,12,12,16,39,41.0,23,22,3,19,10,47,22,0
407,Victor Osimhen,NGA,FW,Napoli,21,1998,17.5,22,15,2,6,14,3,15,20.0,12,6,0,6,7,29,10,0
408,Yordan Osorio,VEN,DF,Parma,26,1994,20.1,22,14,13,9,0,9,24,37.5,15,30,18,12,53,75,77,1
409,David Ospina,COL,GK,Napoli,31,1988,16.0,0,0,0,0,0,0,0,,0,0,0,0,0,0,4,0
410,Adam Ounas,ALG,FW|MF,Crotone,23,1996,13.3,9,4,4,4,1,0,7,0.0,7,12,1,11,3,12,4,0
411,Adam Ounas,ALG,MF|FW,Cagliari,23,1996,3.4,3,2,3,0,0,0,11,0.0,11,5,0,5,3,6,0,0
412,Thomas Ouwejan,NED,DF,Udinese,23,1996,4.6,4,1,0,3,1,2,9,22.2,7,4,0,4,5,9,6,0
413,Daniele Padelli,ITA,GK,Inter,34,1985,0.5,0,0,0,0,0,0,0,,0,0,0,0,0,0,0,0
414,Mattia Pagliuca,ITA,MF,Bologna,18,2002,0.1,0,0,0,0,0,0,0,,0,0,0,0,1,1,0,0
415,Rodrigo Palacio,ARG,FW,Bologna,38,1982,27.8,13,6,2,3,8,1,15,6.7,14,18,0,18,7,20,29,0
416,Alberto Paleari,ITA,GK,Genoa,27,1992,2.3,0,0,0,0,0,0,0,,0,0,0,0,0,0,1,0
417,Antonio Palumbo,ITA,MF,Sampdoria,23,1996,0.1,0,0,0,0,0,0,1,0.0,1,0,0,0,0,0,0,0
418,Martin Palumbo,NOR,MF,Udinese,18,2002,0.7,0,0,0,0,0,0,0,,0,5,0,5,1,1,0,0
419,Goran Pandev,MKD,FW|MF,Genoa,37,1983,15.6,9,5,1,6,2,4,10,40.0,6,6,0,6,2,11,7,1
420,Ivor Pandur,CRO,GK,Hellas Verona,20,2000,3.7,0,0,0,0,0,0,0,,0,0,0,0,0,0,0,0
421,Vittorio Parigini,ITA,MF|DF,Genoa,24,1996,0.6,5,2,4,0,1,0,1,0.0,1,0,0,0,0,5,0,0
422,Marco Parolo,ITA,DF|MF,Lazio,35,1985,7.3,21,8,8,11,2,8,20,40.0,12,20,6,14,14,35,31,0
423,Mario Pašalić,CRO,MF,Atalanta,25,1995,12.5,26,15,5,17,4,12,19,63.2,7,12,1,11,8,34,6,0
424,Christian Pastina,ITA,DF,Benevento,19,2001,1.3,0,0,0,0,0,0,1,0.0,1,1,0,1,1,1,8,0
425,Javier Pastore,ARG,MF|FW,Roma,31,1989,0.9,2,2,2,0,0,2,2,100.0,0,0,0,0,0,2,0,0
426,Patric,ESP,DF,Lazio,27,1993,17.7,30,16,15,11,4,13,24,54.2,11,13,3,10,18,48,51,1
427,Leonardo Pavoletti,ITA,FW,Cagliari,31,1988,17.6,7,3,2,5,0,1,20,5.0,19,4,2,2,4,11,32,0
428,Nehuén Paz,ARG,DF,Bologna,27,1993,4.0,9,4,4,5,0,6,7,85.7,1,4,2,2,11,20,16,0
429,Pedro,ESP,MF|FW,Roma,33,1987,17.7,22,14,6,11,5,7,35,20.0,28,10,0,10,9,31,2,1
430,João Pedro,ITA,FW|MF,Cagliari,28,1992,36.1,13,6,2,6,5,2,27,7.4,25,32,6,26,13,26,28,0
431,Gianluca Pegolo,ITA,GK,Sassuolo,39,1981,1.0,0,0,0,0,0,0,0,,0,0,0,0,0,0,1,0
432,Graziano Pellè,ITA,FW,Parma,35,1985,6.8,2,2,0,1,1,1,8,12.5,7,3,0,3,2,4,8,0
433,Lorenzo Pellegrini,ITA,MF,Roma,24,1996,28.9,40,24,13,20,7,21,60,35.0,39,37,2,35,42,82,23,1
434,Luca Pellegrini,ITA,DF|MF,Genoa,21,1999,7.1,9,6,6,2,1,4,10,40.0,6,11,2,9,8,17,13,1
435,Federico Peluso,ITA,DF,Sassuolo,36,1984,2.3,1,1,1,0,0,1,2,50.0,1,2,2,0,3,4,12,0
436,Andreas Pereira,BRA,FW|MF,Lazio,24,1996,6.0,5,0,1,3,1,2,12,16.7,10,6,0,6,1,6,4,0
437,Pedro Pereira,POR,DF,Crotone,22,1998,28.3,50,32,29,17,4,21,40,52.5,19,33,11,22,19,69,61,0
438,Gastón Pereiro,URU,MF|DF,Cagliari,25,1995,3.0,3,1,2,1,0,1,2,50.0,1,2,0,2,1,4,2,1
439,Bruno Peres,BRA,DF,Roma,30,1990,15.9,21,11,11,7,3,13,24,54.2,11,18,4,14,27,48,11,0
440,Roberto Pereyra,ARG,MF|FW,Udinese,29,1991,32.5,18,11,7,8,3,7,23,30.4,16,24,5,19,27,45,24,0
441,Carles Pérez,ESP,MF|FW,Roma,22,1998,8.6,9,4,3,6,0,6,31,19.4,25,9,0,9,6,15,1,0
442,Mattia Perin,ITA,GK,Genoa,27,1992,32.0,0,0,0,0,0,0,0,,0,0,0,0,1,1,6,0
443,Ivan Perišić,CRO,DF|FW,Inter,31,1989,19.9,22,13,11,6,5,12,33,36.4,21,33,4,29,19,41,36,1
444,Matteo Pessina,ITA,MF,Atalanta,23,1997,18.3,14,7,4,6,4,7,24,29.2,17,17,2,15,17,31,7,1
445,Andrea Petagna,ITA,FW,Napoli,25,1995,10.7,2,0,0,2,0,2,7,28.6,5,4,0,4,1,3,7,0
446,Jacopo Petriccione,ITA,MF,Crotone,25,1995,10.6,14,8,6,7,1,9,24,37.5,15,11,2,9,8,22,11,0
447,Jens Petter Hauge,NOR,FW,Milan,20,1999,5.9,7,4,3,3,1,6,10,60.0,4,4,0,4,1,8,3,0
448,Germán Pezzella,ARG,DF,Fiorentina,29,1991,30.5,34,20,22,12,0,18,32,56.3,14,26,14,12,36,70,109,1
449,Giuseppe Pezzella,ITA,DF,Parma,22,1997,20.3,34,19,23,9,2,22,41,53.7,19,22,9,13,12,46,52,3
450,Cristiano Piccini,ITA,DF,Atalanta,27,1992,0.7,1,1,1,0,0,0,1,0.0,1,1,0,1,0,1,0,0
451,Roberto Piccoli,ITA,FW,Spezia,19,2001,7.8,7,3,0,4,3,2,4,50.0,2,4,0,4,2,9,5,0
452,Andrea Pinamonti,ITA,FW,Inter,21,1999,1.9,0,0,0,0,0,0,0,,0,1,0,1,1,1,2,0
453,Carlo Pinsoglio,ITA,GK,Juventus,30,1990,0.3,0,0,0,0,0,0,0,,0,0,0,0,0,0,0,0
454,Fabio Pisacane,ITA,DF,Cagliari,34,1986,2.5,3,2,2,1,0,3,7,42.9,4,8,5,3,1,4,9,1
455,Marko Pjaca,CRO,FW|MF,Genoa,25,1995,15.8,13,6,6,3,4,4,16,25.0,12,7,2,5,7,20,12,0
456,Tommaso Pobega,ITA,MF,Spezia,21,1999,13.7,24,13,7,13,4,11,31,35.5,20,10,2,8,9,33,22,0
457,Andrea Poli,ITA,MF,Bologna,30,1989,4.3,9,7,4,2,3,6,12,50.0,6,7,1,6,7,16,7,0
458,Matteo Politano,ITA,FW|MF,Napoli,26,1993,21.2,24,16,13,9,2,11,47,23.4,36,14,1,13,14,38,18,0
459,Manolo Portanova,ITA,MF|FW,Genoa,20,2000,0.7,3,3,1,1,1,0,2,0.0,2,3,1,2,1,4,2,0
460,Manolo Portanova,ITA,MF,Juventus,20,2000,0.8,2,0,2,0,0,0,2,0.0,2,4,1,3,0,2,1,0
461,Ivan Provedel,ITA,GK,Spezia,26,1994,29.0,2,0,2,0,0,2,6,33.3,4,0,0,0,2,4,20,1
462,Erick Pulgar,CHI,MF,Fiorentina,26,1994,22.2,41,18,17,23,1,22,49,44.9,27,24,10,14,41,82,45,1
463,Ignacio Pussetto,ARG,FW,Udinese,24,1995,8.4,16,8,5,6,5,6,17,35.3,11,14,0,14,13,29,6,0
464,Fabio Quagliarella,ITA,FW,Sampdoria,37,1983,24.5,12,8,4,4,4,2,19,10.5,17,14,1,13,7,19,10,0
465,Simone Rabbi,ITA,FW|DF,Bologna,18,2001,0.4,0,0,0,0,0,0,1,0.0,1,0,0,0,0,0,0,0
466,Adrien Rabiot,FRA,MF,Juventus,25,1995,25.7,72,42,24,41,7,28,60,46.7,32,32,11,21,43,115,29,1
467,Ivan Radovanović,SRB,DF|MF,Genoa,31,1988,24.8,18,15,13,5,0,12,31,38.7,19,39,21,18,37,55,114,2
468,Ionuț Radu,ROU,GK,Inter,23,1997,1.5,0,0,0,0,0,0,0,,0,0,0,0,0,0,1,0
469,Ștefan Radu,ROU,DF,Lazio,33,1986,27.3,43,24,20,19,4,25,40,62.5,15,27,14,13,45,88,73,1
470,Rafael,BRA,GK,Spezia,38,1982,2.3,0,0,0,0,0,0,0,,0,0,0,0,0,0,0,0
471,Antonio Raimondo,ITA,FW,Bologna,16,2004,0.0,0,0,0,0,0,0,0,,0,0,0,0,0,0,0,0
472,Gastón Ramírez,URU,FW|MF,Sampdoria,29,1990,10.8,31,15,10,17,4,8,27,29.6,19,19,3,16,4,35,13,0
473,Aaron Ramsey,WAL,MF,Juventus,29,1990,12.1,22,14,8,13,1,8,25,32.0,17,13,2,11,7,29,8,2
474,Andrea Ranocchia,ITA,DF,Inter,32,1988,7.8,13,10,6,6,1,7,8,87.5,1,5,3,2,12,25,19,0
475,Giacomo Raspadori,ITA,FW|MF,Sassuolo,20,2000,13.7,5,3,1,1,3,0,4,0.0,4,13,5,8,2,7,9,0
476,Federico Ravaglia,ITA,GK,Bologna,20,1999,4.0,0,0,0,0,0,0,1,0.0,1,0,0,0,0,0,2,0
477,Ante Rebić,CRO,FW,Milan,26,1993,19.7,26,9,4,8,14,8,37,21.6,29,21,1,20,7,33,17,0
478,Arkadiusz Reca,POL,DF,Crotone,25,1995,25.7,34,16,15,11,8,10,45,22.2,35,30,3,27,50,84,64,0
479,Vasco Regini,ITA,DF,Sampdoria,29,1990,1.0,2,2,2,0,0,2,2,100.0,0,1,1,0,1,3,5,0
480,Pepe Reina,ESP,GK,Lazio,37,1982,29.0,0,0,0,0,0,0,1,0.0,1,0,0,0,1,1,6,0
481,Bryan Reynolds,USA,DF,Roma,19,2001,3.1,4,2,1,1,2,1,5,20.0,4,4,0,4,6,10,4,0
482,Franck Ribéry,FRA,FW,Fiorentina,37,1983,23.9,24,11,4,9,11,5,29,17.2,24,11,2,9,3,27,1,0
483,Federico Ricci,ITA,FW,Sassuolo,26,1994,0.0,0,0,0,0,0,0,0,,0,0,0,0,0,0,0,0
484,Giacomo Ricci,ITA,DF,Parma,23,1996,0.7,3,1,1,2,0,0,0,,0,2,2,0,1,4,4,0
485,Matteo Ricci,ITA,MF,Spezia,26,1994,24.8,40,23,14,24,2,27,52,51.9,25,24,4,20,34,74,13,0
486,Tomás Rincón,VEN,MF,Torino,32,1988,31.6,68,38,27,33,8,36,71,50.7,35,32,7,25,31,99,44,0
487,Andrea Rispoli,ITA,DF,Crotone,31,1988,7.2,6,3,2,3,1,2,7,28.6,5,12,3,9,5,11,15,1
488,Emmanuel Rivière,FRA,FW,Crotone,30,1990,7.1,2,1,2,0,0,0,3,0.0,3,5,1,4,1,3,0,0
489,Ricardo Rodríguez,SUI,DF,Torino,27,1992,13.8,21,14,11,8,2,13,22,59.1,9,16,5,11,20,41,43,0
490,Marko Rog,CRO,MF,Cagliari,25,1995,12.9,40,24,15,22,3,16,37,43.2,21,17,6,11,19,59,15,0
491,Rogério,BRA,DF,Sassuolo,22,1998,20.9,26,13,19,5,2,19,27,70.4,8,26,5,21,31,57,53,0
492,Luis Rojas,CHI,MF|FW,Crotone,18,2002,1.2,1,0,0,1,0,1,2,50.0,1,2,0,2,1,2,0,0
493,Alessio Romagnoli,ITA,DF,Milan,25,1995,21.2,17,7,8,7,2,8,19,42.1,11,29,22,7,24,41,80,0
494,Cristian Romero,ARG,DF,Atalanta,22,1998,28.3,63,32,41,19,3,27,49,55.1,22,31,13,18,96,159,71,2
495,Cristiano Ronaldo,POR,FW,Juventus,35,1985,31.1,6,3,1,3,2,3,15,20.0,12,11,3,8,5,11,15,1
496,Marten de Roon,NED,MF,Atalanta,29,1991,33.6,80,48,30,36,14,36,84,42.9,48,44,9,35,69,149,40,0
497,Nicolò Rovella,ITA,MF,Genoa,18,2001,13.2,29,16,15,11,3,9,32,28.1,23,11,0,11,20,49,19,1
498,Amir Rrahmani,KVX,DF,Napoli,26,1994,12.2,13,8,7,6,0,6,9,66.7,3,17,14,3,8,21,39,1
499,Kevin Rüegg,SUI,DF|MF,Hellas Verona,21,1998,2.3,0,0,0,0,0,0,0,,0,3,0,3,2,2,3,0
500,Daniele Rugani,ITA,DF,Cagliari,26,1994,11.1,24,11,10,12,2,10,20,50.0,10,15,10,5,15,39,46,0
501,Matteo Ruggeri,ITA,DF,Atalanta,18,2002,2.3,3,0,1,2,0,2,3,66.7,1,2,0,2,4,7,2,0
502,Mário Rui,POR,DF,Napoli,29,1991,18.5,24,13,17,6,1,17,33,51.5,16,17,4,13,28,52,29,1
503,Fabián Ruiz Peña,ESP,MF,Napoli,24,1996,28.5,58,31,26,21,11,25,70,35.7,45,33,3,30,36,94,32,1
504,Alexis Saelemaekers,BEL,FW,Milan,21,1999,22.4,43,26,20,18,5,19,60,31.7,41,29,1,28,25,68,6,0
505,Jacopo Sala,ITA,DF,Spezia,28,1991,4.2,17,9,14,1,2,8,22,36.4,14,5,2,3,5,22,6,0
506,Eddie Salcedo,ITA,MF|FW,Hellas Verona,18,2001,8.4,6,2,3,2,1,3,3,100.0,0,6,0,6,6,12,6,0
507,Antonio Sanabria,PAR,FW,Torino,24,1996,10.9,8,3,0,4,4,2,9,22.2,7,5,0,5,5,13,8,0
508,Alexis Sánchez,CHI,FW,Inter,31,1988,12.7,14,8,4,4,6,5,18,27.8,13,11,0,11,7,21,1,1
509,Alex Sandro,BRA,DF,Juventus,29,1991,20.6,37,23,19,13,5,13,25,52.0,12,20,4,16,31,68,57,0
510,Siriki Sanogo,CIV,MF,Benevento,18,2001,0.1,0,0,0,0,0,0,0,,0,0,0,0,0,0,0,0
511,Nicola Sansone,ITA,FW|MF,Bologna,28,1991,13.0,22,11,7,12,3,10,31,32.3,21,15,0,15,9,31,7,0
512,Federico Santander,PAR,FW,Bologna,29,1991,0.4,0,0,0,0,0,0,0,,0,0,0,0,0,0,0,0
513,Davide Santon,ITA,DF,Roma,29,1991,6.5,4,3,2,2,0,3,7,42.9,4,10,1,9,4,8,12,0
514,Samir Santos,BRA,DF,Udinese,25,1994,24.6,40,23,26,12,2,13,29,44.8,16,33,17,16,58,98,60,1
515,Riccardo Saponara,ITA,MF,Fiorentina,28,1991,0.6,2,1,0,2,0,1,3,33.3,2,0,0,0,1,3,0,0
516,Riccardo Saponara,ITA,FW|MF,Spezia,28,1991,4.3,4,1,1,0,3,1,3,33.3,2,1,0,1,1,5,4,0
517,Marco Sau,ITA,MF|FW,Benevento,32,1987,8.7,6,2,0,6,0,1,16,6.3,15,7,0,7,5,11,3,0
518,Gianluca Scamacca,ITA,FW,Genoa,21,1999,15.0,19,10,6,7,6,7,19,36.8,12,21,4,17,9,28,12,0
519,Nicolás Schiappacasse,URU,MF,Sassuolo,21,1999,0.2,0,0,0,0,0,0,0,,0,0,0,0,0,0,0,0
520,Pasquale Schiattarella,ITA,MF,Benevento,33,1987,25.0,37,22,25,12,0,19,47,40.4,28,19,5,14,32,69,29,2
521,Jerdy Schouten,NED,MF,Bologna,23,1997,27.9,50,25,23,25,2,16,37,43.2,21,36,13,23,79,129,37,6
522,Matteo Scozzarella,ITA,MF,Parma,32,1988,1.7,4,0,3,1,0,2,3,66.7,1,3,1,2,6,10,0,0
523,Simone Scuffet,ITA,GK,Udinese,24,1996,1.0,0,0,0,0,0,0,0,,0,0,0,0,0,0,0,0
524,Jacopo Segre,ITA,MF,Torino,23,1997,2.1,5,2,2,1,2,2,5,40.0,3,0,0,0,0,5,1,0
525,Léo Sena,BRA,MF,Spezia,24,1995,9.8,22,12,7,10,5,12,26,46.2,14,19,4,15,11,33,5,0
526,Stefano Sensi,ITA,MF,Inter,24,1995,6.7,9,6,3,5,1,4,11,36.4,7,6,1,5,7,16,1,0
527,Luigi Sepe,ITA,GK,Parma,29,1991,36.0,0,0,0,0,0,0,2,0.0,2,0,0,0,2,2,13,2
528,Stephan El Shaarawy,ITA,MF|FW,Roma,27,1992,6.4,4,3,0,3,1,2,9,22.2,7,3,1,2,3,7,2,0
529,Eldor Shomurodov,UZB,FW,Genoa,25,1995,18.6,28,14,7,13,8,9,37,24.3,28,17,2,15,6,34,11,0
530,Luca Siligardi,ITA,MF|FW,Crotone,32,1988,0.5,4,2,0,3,1,1,5,20.0,4,0,0,0,0,4,0,0
531,Luca Siligardi,ITA,FW|MF,Parma,32,1988,0.4,0,0,0,0,0,0,2,0.0,2,0,0,0,0,0,0,0
532,Adrien Silva,POR,MF,Sampdoria,31,1989,17.8,49,22,21,22,6,18,54,33.3,36,34,1,33,30,79,10,1
533,Marco Silvestri,ITA,GK,Hellas Verona,29,1991,34.0,0,0,0,0,0,0,0,,0,0,0,0,0,0,14,1
534,Giovanni Simeone,ARG,FW,Cagliari,25,1995,19.3,24,11,2,15,7,7,31,22.6,24,23,1,22,10,34,18,0
535,Wilfried Singo,CIV,DF,Torino,19,2000,20.6,29,14,16,6,7,17,33,51.5,16,13,3,10,29,58,40,0
536,Salvatore Sirigu,ITA,GK,Torino,33,1987,32.0,1,0,1,0,0,1,2,50.0,1,0,0,0,0,1,6,2
537,Łukasz Skorupski,POL,GK,Bologna,29,1991,28.0,1,1,1,0,0,1,4,25.0,3,0,0,0,0,1,23,5
538,Andreas Skov Olsen,DEN,FW|DF,Bologna,20,1999,13.1,19,10,11,4,4,11,21,52.4,10,15,0,15,3,22,25,0
539,Milan Škriniar,SVK,DF,Inter,25,1995,30.9,48,32,29,16,3,23,34,67.6,11,30,19,11,30,78,89,1
540,Chris Smalling,ENG,DF,Roma,30,1989,12.3,14,8,5,7,2,6,10,60.0,4,17,11,6,28,42,46,1
541,Simon Sohm,SUI,MF,Parma,19,2001,10.0,18,12,11,6,1,11,26,42.3,15,8,0,8,5,23,7,0
542,Roberto Soriano,ITA,MF,Bologna,29,1991,36.1,48,26,15,20,13,15,64,23.4,49,31,8,23,18,66,43,0
543,Riccardo Sottil,ITA,FW|MF,Cagliari,21,1999,13.2,7,3,2,3,2,0,7,0.0,7,4,0,4,5,12,3,0
544,Adama Soumaoro,FRA,DF,Bologna,28,1992,19.5,24,14,17,7,0,6,12,50.0,6,28,23,5,20,44,72,0
545,Leonardo Spinazzola,ITA,DF,Roma,27,1993,23.6,12,6,3,9,0,8,20,40.0,12,16,1,15,25,37,31,0
546,Marco Sportiello,ITA,GK,Atalanta,28,1992,14.0,2,2,2,0,0,1,3,33.3,2,0,0,0,2,4,5,1
547,Mattia Sprocati,ITA,MF|FW,Parma,27,1993,0.2,1,0,0,1,0,1,1,100.0,0,0,0,0,1,2,0,0
548,Thomas Strakosha,ALB,GK,Lazio,25,1995,9.0,1,1,1,0,0,0,0,,0,0,0,0,1,2,4,0
549,Kevin Strootman,NED,MF,Genoa,30,1990,14.6,30,18,13,15,2,14,32,43.8,18,35,3,32,25,55,18,0
550,Jens Stryger Larsen,DEN,DF,Udinese,29,1991,29.3,17,11,14,3,0,8,25,32.0,17,26,11,15,24,41,65,0
551,Stefano Sturaro,ITA,MF,Hellas Verona,27,1993,4.7,4,3,3,0,1,2,8,25.0,6,5,1,4,5,9,10,0
552,Stefano Sturaro,ITA,MF,Genoa,27,1993,4.9,11,5,3,6,2,3,15,20.0,12,5,0,5,7,18,2,0
553,Bosko Sutalo,CRO,DF,Atalanta,20,2000,2.6,5,5,0,3,2,4,5,80.0,1,2,1,1,2,7,7,1
554,Mattias Svanberg,SWE,MF,Bologna,21,1999,20.6,38,17,21,9,8,16,45,35.6,29,25,4,21,30,68,25,1
555,Wojciech Szczęsny,POL,GK,Juventus,30,1990,29.7,0,0,0,0,0,0,0,,0,2,0,2,3,3,5,1
556,Adrien Tameze,CMR,MF,Hellas Verona,26,1994,25.6,39,25,23,15,1,11,27,40.7,16,31,8,23,32,71,46,2
557,Ciprian Tătărușanu,ROU,GK,Milan,34,1986,1.0,0,0,0,0,0,0,0,,0,0,0,0,0,0,0,1
558,Andrés Tello,COL,DF|MF,Benevento,23,1996,4.6,9,6,8,0,1,5,20,25.0,15,8,1,7,6,15,6,0
559,Hidde ter Avest,NED,DF,Udinese,23,1997,3.9,5,2,3,2,0,2,5,40.0,3,3,1,2,2,7,5,0
560,Pietro Terracciano,ITA,GK,Fiorentina,30,1990,3.0,0,0,0,0,0,0,0,,0,0,0,0,0,0,1,0
561,Claudio Terzi,ITA,DF,Spezia,36,1984,20.8,34,21,19,14,1,19,28,67.9,9,23,12,11,35,69,55,1
562,Morten Thorsby,NOR,MF,Sampdoria,24,1996,29.4,76,42,32,36,8,20,60,33.3,40,51,16,35,25,101,30,0
563,Jeremy Toljan,GER,DF,Sassuolo,25,1994,16.6,21,12,16,3,2,12,27,44.4,15,15,7,8,13,34,28,0
564,Rafael Tolói,ITA,DF,Atalanta,29,1990,28.2,51,23,21,26,4,26,48,54.2,22,37,7,30,33,84,66,0
565,Takehiro Tomiyasu,JPN,DF,Bologna,21,1998,30.2,47,31,27,14,6,21,34,61.8,13,37,19,18,54,101,106,0
566,Fikayo Tomori,ENG,DF,Milan,22,1997,16.3,28,18,17,9,2,8,14,57.1,6,32,20,12,18,46,61,1
567,Sandro Tonali,ITA,MF,Milan,20,2000,14.8,28,19,14,13,1,13,28,46.4,15,18,5,13,22,50,18,0
568,Lorenzo Tonelli,ITA,DF,Sampdoria,30,1990,19.8,33,18,20,11,2,10,21,47.6,11,21,14,7,25,58,94,1
569,Ernesto Torregrossa,VEN,FW,Sampdoria,28,1992,1.9,1,1,0,0,1,0,2,0.0,2,4,0,4,1,2,1,0
570,Mattéo Tramoni,FRA,MF|FW,Cagliari,20,2000,0.8,4,2,2,1,1,1,2,50.0,1,5,0,5,1,5,2,0
571,Chaka Traorè,CIV,FW|DF,Parma,15,2004,0.2,0,0,0,0,0,0,0,,0,0,0,0,0,0,1,1
572,Alessandro Tripaldelli,ITA,DF,Cagliari,21,1999,3.3,13,6,5,6,2,5,6,83.3,1,6,1,5,3,16,15,0
573,Alessandro Tuia,ITA,DF,Benevento,30,1990,19.6,39,17,34,4,1,15,25,60.0,10,22,10,12,36,75,91,1
574,Ľubomír Tupta,SVK,FW,Hellas Verona,22,1998,0.6,0,0,0,0,0,0,0,,0,0,0,0,0,0,0,0
575,Destiny Udogie,ITA,DF|MF,Hellas Verona,17,2002,1.9,6,4,2,2,2,2,2,100.0,0,3,0,3,2,8,4,0
576,Samir Ujkani,KVX,GK,Torino,32,1988,1.0,0,0,0,0,0,0,0,,0,0,0,0,0,0,1,0
577,Kacper Urbanski,POL,FW,Bologna,15,2004,0.0,0,0,0,0,0,0,0,,0,0,0,0,0,0,0,0
578,Lautaro Valenti,ARG,DF,Parma,21,1999,5.5,10,4,7,2,1,6,15,40.0,9,11,3,8,11,21,30,0
579,Borja Valero,ESP,MF|FW,Fiorentina,35,1985,5.5,13,9,7,4,2,3,15,20.0,12,6,1,5,6,19,2,0
580,Denis Vavro,SVK,DF,Lazio,24,1996,0.4,0,0,0,0,0,0,1,0.0,1,0,0,0,1,1,3,0
581,Matías Vecino,URU,MF,Inter,28,1991,3.1,1,1,0,0,1,0,5,0.0,5,7,1,6,4,5,3,0
582,Miguel Veloso,POR,MF,Hellas Verona,34,1986,14.6,24,17,10,10,4,12,34,35.3,22,12,1,11,12,36,25,0
583,Lorenzo Venuti,ITA,DF,Fiorentina,25,1995,19.5,24,11,14,7,3,14,28,50.0,14,18,3,15,17,41,24,0
584,Daniele Verde,ITA,FW,Spezia,24,1996,10.9,5,4,2,2,1,4,10,40.0,6,5,0,5,9,14,7,0
585,Simone Verdi,ITA,MF|FW,Torino,28,1992,18.0,19,12,10,6,3,6,19,31.6,13,8,0,8,8,27,2,2
586,Jordan Veretout,FRA,MF,Roma,27,1993,22.8,20,12,8,12,0,9,33,27.3,24,14,3,11,14,34,21,3
587,Edoardo Vergani,ITA,FW,Bologna,19,2001,0.1,0,0,0,0,0,0,0,,0,0,0,0,0,0,0,0
588,Valerio Verre,ITA,FW|MF,Sampdoria,26,1994,11.1,11,7,2,7,2,4,19,21.1,15,14,2,12,9,20,3,0
589,Guglielmo Vicario,ITA,GK,Cagliari,23,1996,4.0,0,0,0,0,0,0,0,,0,0,0,0,0,0,1,0
590,Arturo Vidal,CHI,MF,Inter,33,1987,12.6,27,14,8,13,6,12,41,29.3,29,23,3,20,29,56,11,0
591,Ronaldo Vieira,ENG,MF|DF,Hellas Verona,22,1998,2.5,5,3,1,3,1,0,2,0.0,2,4,3,1,0,5,2,0
592,Luca Vignali,ITA,DF,Spezia,24,1996,17.7,19,9,10,6,3,7,25,28.0,18,13,5,8,22,41,25,0
593,Emanuel Vignato,ITA,FW|MF,Bologna,19,2000,13.4,18,9,9,6,3,3,15,20.0,12,6,1,5,10,28,7,0
594,Gonzalo Villar,ESP,MF,Roma,22,1998,20.7,44,18,14,24,6,18,61,29.5,43,25,3,22,22,66,14,1
595,Nicolas Viola,ITA,MF,Benevento,30,1989,11.5,16,9,2,11,3,6,28,21.4,22,10,3,7,9,25,7,0
596,Dušan Vlahović,SRB,FW,Fiorentina,20,2000,32.5,13,4,3,4,6,5,16,31.3,11,16,2,14,4,17,15,0
597,Mërgim Vojvoda,KVX,DF|FW,Torino,25,1995,15.1,24,14,18,5,1,12,22,54.5,10,19,4,15,18,42,35,1
598,Stefan de Vrij,NED,DF,Inter,28,1992,30.4,28,16,15,12,1,15,24,62.5,9,24,18,6,41,69,95,0
599,Giacomo Vrioni,ALB,FW,Juventus,21,1998,0.0,0,0,0,0,0,0,0,,0,0,0,0,0,0,0,0
600,Miloš Vulić,SRB,MF,Crotone,23,1996,14.5,15,8,9,1,5,8,21,38.1,13,10,1,9,8,23,8,0
601,Walace,BRA,MF,Udinese,25,1995,22.8,50,23,28,19,3,21,60,35.0,39,36,3,33,34,84,23,0
602,Sebastian Walukiewicz,POL,DF,Cagliari,20,2000,18.0,27,19,11,13,3,12,30,40.0,18,22,14,8,36,63,60,0
603,Maya Yoshida,JPN,DF,Sampdoria,31,1988,25.3,17,4,10,7,0,7,13,53.8,6,45,34,11,57,74,93,1
604,Ashley Young,ENG,DF,Inter,35,1985,15.8,15,7,8,4,3,3,13,23.1,10,13,0,13,6,21,31,0
605,Mattia Zaccagni,ITA,MF,Hellas Verona,25,1995,29.0,27,13,8,11,8,8,25,32.0,17,28,4,24,27,54,13,1
606,Vasilios Zagaritis,GRE,DF,Parma,19,2001,0.7,0,0,0,0,0,0,0,,0,1,0,1,0,0,0,0
607,Miha Zajc,SVN,MF,Genoa,26,1994,20.7,22,14,9,10,3,13,39,33.3,26,30,4,26,27,49,19,0
608,Nicola Zalewski,POL,MF,Roma,18,2002,0.1,1,1,0,1,0,1,1,100.0,0,0,0,0,0,1,0,0
609,Niccolò Zanellato,ITA,MF,Crotone,22,1998,18.2,24,14,16,6,2,13,36,36.1,23,19,5,14,16,40,12,2
610,Cristián Zapata,COL,DF,Genoa,33,1986,10.8,18,12,11,7,0,10,14,71.4,4,15,11,4,15,33,56,0
611,Duván Zapata,COL,FW,Atalanta,29,1991,26.4,12,5,2,3,7,4,13,30.8,9,19,5,14,6,18,19,0
612,Gabriele Zappa,ITA,DF,Cagliari,20,1999,26.6,34,17,16,15,3,22,49,44.9,27,36,4,32,24,58,50,0
613,Davide Zappacosta,ITA,DF,Genoa,28,1992,22.7,33,16,15,13,5,15,30,50.0,15,17,1,16,18,51,41,0
614,Simone Zaza,ITA,FW,Torino,29,1991,16.6,15,9,4,6,5,6,20,30.0,14,14,0,14,3,18,5,1
615,Marvin Zeegelaar,NED,DF,Udinese,29,1990,19.3,40,18,23,16,1,20,39,51.3,19,21,9,12,24,64,43,0
616,Piotr Zieliński,POL,MF,Napoli,26,1994,28.0,18,10,8,7,3,7,20,35.0,13,23,4,19,18,36,12,0
617,Joshua Zirkzee,NED,FW|MF,Parma,19,2001,1.3,2,2,1,1,0,1,3,33.3,2,1,1,0,0,2,1,0
618,Jeroen Zoet,NED,GK,Spezia,29,1991,6.7,0,0,0,0,0,0,1,0.0,1,0,0,0,0,0,4,2
619,Filip Đuričić,SRB,MF|FW,Sassuolo,28,1992,23.1,32,23,6,16,10,12,30,40.0,18,20,2,18,9,41,12,0
