Rk,Player,Nation,Pos,Squad,Age,Born,90s,Tackles Tkl,Tackles TklW,Tackles Def 3rd,Tackles Mid 3rd,Tackles Att 3rd,Challenges Tkl,Challenges Att,Challenges Tkl%,Challenges Lost,Blocks Blocks,Blocks Sh,Blocks Pass,Int,Tkl+Int,Clr,Err
1,Yunis Abdelhamid,MAR,DF,Reims,33,1987,33.1,48,27,34,14,0,16,32,50.0,16,50,25,25,68,116,104,0
2,Salis Abdul Samed,GHA,MF,Clermont Foot,21,2000,27.4,43,23,25,16,2,20,57,35.1,37,18,1,17,42,85,15,0
3,Laurent Abergel,FRA,MF,Lorient,28,1993,32.8,110,60,44,53,13,71,166,42.8,95,58,1,57,55,165,13,0
4,Charles Abi,FRA,FW,Saint-Étienne,21,2000,0.5,0,0,0,0,0,0,1,0.0,1,2,0,2,0,0,0,0
5,Matthis Abline,FRA,FW,Rennes,18,2003,1.1,0,0,0,0,0,0,0,,0,2,0,2,0,0,1,0
6,Mohamed Achi,FRA,MF,Nantes,19,2002,0.1,0,0,0,0,0,0,0,,0,0,0,0,0,0,0,0
7,Martin Adeline,FRA,MF|FW,Reims,17,2003,3.9,15,11,5,8,2,8,16,50.0,8,0,0,0,11,26,6,0
8,Yacine Adli,FRA,MF|FW,Bordeaux,21,2000,25.1,43,27,22,14,7,19,68,27.9,49,33,3,30,37,80,11,2
9,Lucien Agoume,FRA,MF,Brest,19,2002,20.8,51,31,24,20,7,23,45,51.1,22,30,9,21,52,103,27,1
10,Nayef Aguerd,MAR,DF,Rennes,25,1996,30.4,27,18,16,11,0,14,24,58.3,10,24,14,10,24,51,127,1
11,Ruben Aguilar,FRA,DF,Monaco,28,1993,23.8,78,53,39,32,7,43,68,63.2,25,19,4,15,44,122,57,0
12,Anel Ahmedhodžić,BIH,DF,Bordeaux,22,1999,15.0,38,26,27,9,2,20,31,64.5,11,16,8,8,22,60,44,0
13,Jean-Eudes Aholou,CIV,MF,Strasbourg,27,1994,11.2,16,9,4,9,3,5,19,26.3,14,8,1,7,19,35,7,0
14,Ludovic Ajorque,FRA,FW,Strasbourg,27,1994,30.4,36,25,5,19,12,7,40,17.5,33,28,3,25,8,44,31,1
15,Maghnes Akliouche,FRA,MF|FW,Monaco,19,2002,0.6,2,0,0,2,0,0,1,0.0,1,2,0,2,0,2,0,0
16,Sofiane Alakouch,MAR,DF|MF,Metz,23,1998,1.8,7,4,3,4,0,2,5,40.0,3,4,0,4,1,8,4,0
17,Josué Albert,FRA,DF,Clermont Foot,29,1992,0.2,0,0,0,0,0,0,0,,0,0,0,0,1,1,2,0
18,Doğan Alemdar,TUR,GK,Rennes,18,2002,12.0,0,0,0,0,0,0,0,,0,0,0,0,0,0,9,1
19,Mohamed Ali Cho,FRA,FW,Angers,17,2004,20.4,10,5,1,4,5,5,17,29.4,12,17,1,16,8,18,0,1
20,Jim Allevinah,GAB,FW,Clermont Foot,26,1995,16.5,18,13,8,8,2,5,18,27.8,13,11,0,11,6,24,4,0
21,Ibrahim Amadou,FRA,DF|MF,Metz,28,1993,9.0,16,8,10,6,0,8,15,53.3,7,4,2,2,14,30,26,0
22,Jordan Amavi,FRA,DF,Nice,27,1994,4.6,16,10,8,7,1,10,17,58.8,7,3,1,2,15,31,7,0
23,Jordan Amavi,FRA,DF|FW,Marseille,27,1994,1.4,6,5,3,1,2,5,10,50.0,5,1,0,1,1,7,3,0
24,Benjamin André,FRA,MF,Lille,30,1990,30.6,123,69,49,65,9,51,113,45.1,62,49,11,38,50,173,56,0
25,Houssem Aouar,ALG,MF|FW,Lyon,23,1998,27.8,46,30,9,25,12,27,54,50.0,27,26,1,25,20,66,5,0
26,Adil Aouchiche,FRA,MF|FW,Saint-Étienne,19,2002,12.0,13,6,5,5,3,5,33,15.2,28,18,1,17,17,30,4,0
27,Dennis Appiah,FRA,DF,Nantes,29,1992,23.3,55,34,35,18,2,28,48,58.3,20,30,13,17,27,82,74,0
28,Lorenz Assignon,TOG,DF,Rennes,21,2000,6.8,15,10,11,3,1,5,9,55.6,4,3,1,2,11,26,19,0
29,Youcef Atal,ALG,DF,Nice,25,1996,12.7,29,19,17,10,2,14,25,56.0,11,13,2,11,32,61,21,0
30,Jean-Kévin Augustin,FRA,FW|MF,Nantes,24,1997,0.9,1,0,0,0,1,0,3,0.0,3,1,0,1,0,1,0,0
31,Karim Azamoum,FRA,DF,Troyes,31,1990,4.3,6,5,4,2,0,3,5,60.0,2,4,2,2,1,7,10,0
32,Loïc Bade,FRA,DF,Rennes,21,2000,10.9,6,5,4,2,0,3,5,60.0,2,12,10,2,12,18,48,0
33,Benoît Badiashile,FRA,DF,Monaco,20,2001,20.4,36,19,21,15,0,14,23,60.9,9,18,12,6,28,64,68,1
34,Youssouph Badji,SEN,FW|MF,Brest,19,2001,1.5,1,0,0,1,0,0,1,0.0,1,0,0,0,0,1,0,0
35,Stéphane Bahoken,CMR,FW,Angers,29,1992,12.2,13,8,2,7,4,1,9,11.1,8,15,0,15,3,16,3,0
36,Dénys Bain,FRA,DF,Brest,28,1993,2.0,3,3,1,2,0,1,1,100.0,0,3,1,2,3,6,5,0
37,Stefan Bajic,FRA,GK,Saint-Étienne,19,2001,5.7,0,0,0,0,0,0,0,,0,0,0,0,0,0,4,0
38,Cédric Bakambu,COD,FW,Marseille,30,1991,4.0,2,0,1,0,1,0,3,0.0,3,2,0,2,0,2,1,0
39,Abdoulaye Bakayoko,FRA,DF,Saint-Étienne,18,2002,3.4,15,9,13,2,0,8,12,66.7,4,5,4,1,12,27,15,0
40,Dilane Bakwa,FRA,FW|MF,Bordeaux,18,2002,0.5,1,1,0,1,0,1,2,50.0,1,0,0,0,0,1,1,0
41,Ibrahima Baldé,FRA,FW|MF,Lens,18,2003,0.6,0,0,0,0,0,0,0,,0,0,0,0,0,0,0,0
42,Leonardo Balerdi,ARG,DF,Marseille,22,1999,10.6,9,6,9,0,0,5,14,35.7,9,11,4,7,19,28,30,0
43,Abdoulaye Bamba,CIV,DF|FW,Angers,31,1990,5.1,6,5,6,0,0,4,11,36.4,7,5,1,4,9,15,13,0
44,Jonathan Bamba,CIV,MF|FW,Lille,25,1996,27.0,30,12,13,9,8,13,36,36.1,23,24,1,23,21,51,10,0
45,Simon Banza,COD,FW,Lens,24,1996,1.4,2,1,0,0,2,0,2,0.0,2,1,0,1,1,3,2,0
46,Danilo Barbosa,BRA,DF,Nice,25,1996,1.0,0,0,0,0,0,0,0,,0,1,1,0,2,2,10,0
47,Bradley Barcola,FRA,FW|MF,Lyon,18,2002,2.9,7,4,2,3,2,1,8,12.5,7,7,1,6,2,9,1,0
48,Melvin Bard,FRA,DF,Nice,20,2000,28.8,59,37,38,17,4,41,63,65.1,22,33,10,23,51,110,56,0
49,Toma Bašić,CRO,MF,Bordeaux,24,1996,2.3,2,2,1,0,1,0,4,0.0,4,4,1,3,2,4,0,0
50,Amine Bassi,FRA,MF|FW,Metz,23,1997,2.0,6,3,2,3,1,1,3,33.3,2,5,0,5,0,6,0,0
51,Paul Baysse,FRA,MF|DF,Bordeaux,33,1988,0.1,1,1,0,1,0,0,0,,0,0,0,0,0,1,1,0
52,Youcef Belaïli,ALG,MF|FW,Brest,29,1992,9.2,2,1,0,0,2,2,9,22.2,7,5,1,4,7,9,4,0
53,Haris Belkebla,ALG,MF,Brest,27,1994,25.7,46,23,21,21,4,18,39,46.2,21,26,6,20,48,94,30,1
54,Jean-Ricner Bellegarde,FRA,MF,Strasbourg,23,1998,25.9,51,32,21,21,9,17,41,41.5,24,29,4,25,27,78,19,0
55,Jeanöel Belocian,FRA,DF,Rennes,16,2005,0.1,0,0,0,0,0,0,0,,0,0,0,0,0,0,0,0
56,Hatem Ben Arfa,FRA,FW|MF,Lille,34,1987,3.5,4,2,2,1,1,2,4,50.0,2,3,0,3,0,4,1,0
57,Salim Ben Seghir,FRA,MF,Marseille,18,2003,0.0,0,0,0,0,0,0,0,,0,0,0,0,0,0,0,0
58,Wissam Ben Yedder,FRA,FW,Monaco,30,1990,28.1,18,8,1,11,6,6,15,40.0,9,12,1,11,0,18,1,0
59,Darío Benedetto,ARG,FW|MF,Marseille,31,1990,0.6,0,0,0,0,0,0,0,,0,2,0,2,0,0,0,0
60,Walter Benítez,ARG,GK,Nice,28,1993,37.0,0,0,0,0,0,0,2,0.0,2,1,0,1,0,0,12,2
61,Loris Benito,SUI,DF,Bordeaux,29,1992,0.7,0,0,0,0,0,0,0,,0,0,0,0,1,1,3,1
62,Nabil Bentaleb,ALG,MF,Angers,26,1994,16.8,42,24,15,20,7,16,29,55.2,13,24,9,15,28,70,13,0
63,Patrick Berg,NOR,MF,Lens,23,1997,3.4,14,6,6,8,0,0,4,0.0,4,2,1,1,4,18,3,0
64,Mitchell van Bergen,NED,FW|MF,Reims,21,1999,10.9,8,5,7,0,1,6,15,40.0,9,9,0,9,4,12,7,0
65,Valon Berisha,KVX,MF|FW,Reims,28,1993,5.1,10,7,2,5,3,2,10,20.0,8,9,0,9,4,14,3,0
66,Paul Bernardoni,FRA,GK,Angers,24,1997,13.0,3,2,3,0,0,3,4,75.0,1,0,0,0,0,3,8,1
67,Paul Bernardoni,FRA,GK,Saint-Étienne,24,1997,19.0,0,0,0,0,0,0,0,,0,0,0,0,0,0,14,2
68,Juan Bernat,ESP,DF|MF,Paris S-G,28,1993,10.6,24,14,10,10,4,13,18,72.2,5,8,0,8,8,32,16,0
69,Dimitry Bertaud,FRA,GK,Montpellier,23,1998,9.3,0,0,0,0,0,0,1,0.0,1,0,0,0,0,0,5,1
70,Jason Berthomier,FRA,MF,Clermont Foot,31,1990,19.2,29,14,5,17,7,12,34,35.3,22,14,2,12,8,37,4,1
71,Giulian Biancone,FRA,DF|MF,Troyes,21,2000,25.5,70,42,44,22,4,40,69,58.0,29,23,8,15,53,123,71,1
72,El Bilal Touré,MLI,FW,Reims,19,2001,13.3,13,6,4,6,3,2,7,28.6,5,10,3,7,6,19,19,0
73,Jean-Claude Billong,CMR,DF,Clermont Foot,27,1993,10.9,17,8,14,1,2,8,11,72.7,3,9,1,8,10,27,35,0
74,Nathan Bitu Mazala,FRA,DF,Paris S-G,18,2002,0.1,0,0,0,0,0,0,0,,0,1,0,1,0,0,0,0
75,Marco Bizot,NED,GK,Brest,30,1991,38.0,3,1,3,0,0,3,5,60.0,2,1,0,1,0,3,24,1
76,Ludovic Blas,FRA,MF|FW,Nantes,23,1997,32.9,33,18,7,20,6,15,44,34.1,29,33,3,30,31,64,6,1
77,Myron Boadu,NED,FW,Monaco,20,2001,10.7,9,7,2,3,4,1,5,20.0,4,6,0,6,2,11,1,0
78,Jérôme Boateng,GER,DF,Lyon,32,1988,18.0,20,15,11,9,0,9,17,52.9,8,20,10,10,20,40,73,0
79,Antonin Bobichon,FRA,MF|FW,Angers,25,1995,0.4,1,0,0,1,0,0,0,,0,0,0,0,1,2,0,0
80,Quentin Boisgard,FRA,MF|FW,Lorient,24,1997,10.6,19,11,6,10,3,8,17,47.1,9,15,0,15,6,25,5,0
81,Charles Boli,FRA,MF|DF,Lens,22,1998,0.4,2,1,0,2,0,0,0,,0,0,0,0,0,2,0,0
82,Sven Botman,NED,DF,Lille,21,2000,25.0,24,11,13,11,0,12,18,66.7,6,32,21,11,26,50,116,0
83,Denis Bouanga,GAB,FW|MF,Saint-Étienne,26,1994,27.1,46,25,14,13,19,22,63,34.9,41,30,0,30,8,54,34,1
84,Hicham Boudaoui,ALG,MF,Nice,21,1999,18.0,31,18,15,10,6,13,36,36.1,23,17,4,13,18,49,15,0
85,Ryad Boudebouz,ALG,MF|FW,Saint-Étienne,31,1990,25.0,27,15,11,12,4,12,29,41.4,17,17,2,15,10,37,5,0
86,Sofiane Boufal,MAR,FW|MF,Angers,27,1993,25.9,44,29,19,16,9,18,38,47.4,20,19,2,17,7,51,1,0
87,Farid Boulaya,ALG,MF|FW,Metz,28,1993,17.0,18,10,7,9,2,14,38,36.8,24,8,2,6,12,30,5,0
88,Ismaëlben Boura,FRA,DF,Lens,20,2000,1.1,2,2,1,1,0,0,0,,0,1,1,0,2,4,5,0
89,Benjamin Bourigeaud,FRA,FW|MF,Rennes,27,1994,35.5,46,24,16,18,12,24,67,35.8,43,33,3,30,30,76,44,0
90,Redwan Bourles,FRA,MF|FW,Lorient,18,2003,0.2,0,0,0,0,0,0,0,,0,0,0,0,0,0,0,0
91,Domagoj Bradarić,CRO,DF,Lille,21,1999,4.6,11,9,8,2,1,7,12,58.3,5,5,2,3,10,21,7,1
92,Bilal Brahimi,ALG,MF,Nice,21,2000,4.2,1,1,0,1,0,0,2,0.0,2,1,0,1,2,3,1,0
93,Bilal Brahimi,ALG,FW,Angers,21,2000,3.8,1,1,0,1,0,0,3,0.0,3,0,0,0,1,2,1,0
94,Lilian Brassier,FRA,DF,Brest,21,1999,25.1,40,24,23,13,4,10,21,47.6,11,31,21,10,32,72,86,0
95,Jimmy Briand,FRA,FW|MF,Bordeaux,35,1985,2.5,2,0,2,0,0,0,2,0.0,2,0,0,0,1,3,2,0
96,Dylan Bronn,TUN,DF,Metz,26,1995,28.3,47,29,33,13,1,20,31,64.5,11,32,19,13,40,87,78,1
97,Osman Bukari,GHA,FW|MF,Nantes,22,1998,11.2,18,8,7,6,5,8,22,36.4,14,8,0,8,8,26,1,0
98,Maxime Busi,BEL,DF,Reims,21,1999,14.4,26,15,20,5,1,19,36,52.8,17,19,5,14,17,43,28,0
99,Oriol Busquets,ESP,MF,Clermont Foot,22,1999,2.2,3,3,0,3,0,2,6,33.3,4,7,4,3,1,4,2,0
100,Marcin Bułka,POL,GK,Nice,21,1999,1.0,0,0,0,0,0,0,0,,0,0,0,0,0,0,0,0
101,Rémy Cabella,FRA,MF|FW,Montpellier,31,1990,3.5,15,7,4,8,3,5,15,33.3,10,7,0,7,5,20,1,0
102,Jimmy Cabot,FRA,DF,Angers,27,1994,22.3,81,44,59,15,7,47,83,56.6,36,29,0,29,32,113,30,0
103,Anthony Caci,FRA,DF,Strasbourg,24,1997,26.6,65,34,35,24,6,33,55,60.0,22,22,3,19,33,98,49,1
104,Mathieu Cafaro,FRA,MF|FW,Reims,24,1997,2.1,4,2,3,1,0,0,7,0.0,7,2,0,2,3,7,1,0
105,Yannick Cahuzac,FRA,MF,Lens,36,1985,6.9,5,2,2,3,0,0,5,0.0,5,8,2,6,9,14,12,0
106,Marc-Aurèle Caillard,FRA,GK,Metz,27,1994,17.1,0,0,0,0,0,0,2,0.0,2,0,0,0,2,2,9,1
107,Jens Cajuste,SWE,MF|FW,Reims,21,1999,4.0,10,6,6,2,2,6,17,35.3,11,7,2,5,5,15,6,0
108,Duje Ćaleta-Car,CRO,DF,Marseille,24,1996,22.9,21,8,15,6,0,11,14,78.6,3,11,7,4,24,45,55,2
109,Lucas Calodat,FRA,DF,Saint-Étienne,19,2002,0.0,0,0,0,0,0,0,0,,0,0,0,0,0,0,0,0
110,Mahdi Camara,FRA,MF|DF,Saint-Étienne,23,1998,34.1,101,57,39,50,12,39,70,55.7,31,44,8,36,57,158,35,1
111,Mamadou Camara,FRA,FW,Troyes,20,2001,0.4,1,1,1,0,0,0,0,,0,0,0,0,0,1,0,0
112,Eduardo Camavinga,FRA,MF,Rennes,18,2002,1.6,4,1,2,1,1,2,5,40.0,3,1,1,0,1,5,3,0
113,Fali Candé,GNB,DF,Metz,23,1998,10.8,30,18,13,15,2,13,31,41.9,18,11,2,9,6,36,21,0
114,Pierrick Capelle,FRA,MF|DF,Angers,34,1987,13.3,36,24,16,17,3,18,52,34.6,34,12,1,11,16,52,20,0
115,Maxence Caqueret,FRA,MF,Lyon,21,2000,25.9,73,40,29,36,8,30,80,37.5,50,38,10,28,43,116,26,2
116,Irvin Cardona,FRA,FW|MF,Brest,23,1997,14.8,13,7,5,4,4,3,16,18.8,13,10,0,10,5,18,17,0
117,Igor Carioca,BRA,DF,Lorient,24,1996,17.5,27,16,16,8,3,15,43,34.9,28,17,2,15,25,52,28,0
118,Moreto Cassamã,GNB,MF,Reims,23,1998,8.9,12,6,7,4,1,3,19,15.8,16,10,5,5,9,21,5,0
119,Jean-Charles Castelletto,CMR,DF,Nantes,26,1995,27.9,45,24,27,17,1,25,35,71.4,10,38,27,11,30,75,73,0
120,Zeki Çelik,TUR,DF,Lille,24,1997,30.0,64,37,43,17,4,36,63,57.1,27,32,9,23,43,107,62,2
121,Fabien Centonze,FRA,DF,Metz,25,1996,17.6,33,21,22,9,2,13,32,40.6,19,37,8,29,32,65,51,0
122,El Chadaille Bitshiabu,FRA,DF,Paris S-G,16,2005,0.1,0,0,0,0,0,0,0,,0,0,0,0,0,0,2,0
123,Nassim Chadli,FRA,MF|DF,Troyes,20,2001,1.1,5,3,3,0,2,2,4,50.0,2,1,0,1,0,5,0,0
124,Mehdi Chahiri,MAR,DF,Strasbourg,25,1996,0.2,1,1,1,0,0,1,1,100.0,0,0,0,0,0,1,0,0
125,Dylan Chambost,FRA,MF|FW,Troyes,23,1997,8.4,16,11,6,9,1,4,25,16.0,21,9,2,7,8,24,4,0
126,Brendan Chardonnet,FRA,DF,Brest,26,1994,29.8,44,25,32,11,1,29,40,72.5,11,42,29,13,55,99,141,0
127,Xavier Chavalerin,FRA,MF,Troyes,30,1991,30.2,49,26,19,25,5,12,55,21.8,43,32,5,27,39,88,36,0
128,Xavier Chavalerin,FRA,MF,Reims,30,1991,2.4,4,4,2,1,1,1,3,33.3,2,2,0,2,5,9,2,1
129,Rayan Cherki,FRA,FW|MF,Lyon,17,2003,4.9,6,2,1,3,2,4,9,44.4,5,2,0,2,1,7,0,0
130,Pedro Chirivella,ESP,MF,Nantes,24,1997,29.3,49,31,14,26,9,25,70,35.7,45,23,2,21,37,86,11,0
131,Joris Chotard,FRA,MF,Montpellier,19,2001,32.6,59,30,33,23,3,36,78,46.2,42,27,15,12,42,101,56,0
132,Alexis Claude-Maurice,FRA,MF,Nice,23,1998,2.3,2,0,1,0,1,1,4,25.0,3,7,0,7,3,5,1,0
133,Jonathan Clauss,FRA,DF,Lens,28,1992,33.8,63,34,33,20,10,22,55,40.0,33,43,1,42,73,136,51,0
134,Marcus Coco,FRA,MF|FW,Nantes,25,1996,10.3,34,14,17,11,6,8,18,44.4,10,11,1,10,10,44,15,0
135,Abdu Conté,POR,DF,Troyes,23,1998,15.0,22,12,16,5,1,12,24,50.0,12,12,2,10,4,26,10,0
136,Sébastien Corchia,FRA,DF,Nantes,30,1990,14.7,33,20,17,11,5,24,42,57.1,18,24,3,21,13,46,36,0
137,Maxwel Cornet,CIV,DF,Lyon,24,1996,0.7,3,1,1,0,2,3,4,75.0,1,0,0,0,1,4,1,0
138,David Pereira da Costa,POR,MF|FW,Lens,20,2001,16.3,22,12,9,6,7,11,26,42.3,15,12,0,12,13,35,5,0
139,Benoît Costil,FRA,GK,Bordeaux,34,1987,25.0,1,0,1,0,0,1,2,50.0,1,0,0,0,0,1,6,3
140,Kalifa Coulibaly,MLI,FW,Nantes,29,1991,9.4,5,1,1,1,3,0,4,0.0,4,2,2,0,0,5,11,0
141,Nicolas Cozza,FRA,DF,Montpellier,22,1999,30.8,80,47,50,23,7,35,65,53.8,30,35,19,16,38,118,82,1
142,Enzo Crivelli,FRA,FW|MF,Saint-Étienne,26,1995,1.1,1,0,0,0,1,0,0,,0,0,0,0,0,1,1,0
143,Wylan Cyprien,FRA,MF,Nantes,26,1995,16.6,33,17,12,18,3,13,32,40.6,19,16,6,10,10,43,14,2
144,Lucas Da Cunha,FRA,MF,Nice,20,2001,4.4,13,7,2,7,4,6,11,54.5,5,2,0,2,1,14,2,0
145,Lucas Da Cunha,FRA,FW|MF,Clermont Foot,20,2001,9.3,17,11,5,8,4,9,18,50.0,9,13,0,13,1,18,3,0
146,Damien Da Silva,FRA,DF,Lyon,33,1988,12.5,13,9,7,5,1,5,9,55.6,4,15,10,5,22,35,53,1
147,Colin Dagba,FRA,DF,Paris S-G,22,1998,1.8,4,2,2,2,0,3,6,50.0,3,4,2,2,2,6,1,0
148,Flavius Daniliuc,AUT,DF,Nice,20,2001,14.4,46,31,26,17,3,34,43,79.1,9,13,7,6,14,60,34,1
149,Kevin Danso,AUT,DF,Lens,22,1998,31.0,41,29,29,12,0,23,34,67.6,11,38,25,13,40,81,111,0
150,Dante,BRA,DF,Nice,37,1983,31.9,42,29,30,12,0,23,33,69.7,10,43,27,16,49,91,96,1
151,Jonathan David,CAN,FW,Lille,21,2000,31.2,24,9,7,11,6,9,30,30.0,21,14,4,10,5,29,15,0
152,Konrad De La Fuente,USA,FW|MF,Marseille,20,2001,8.7,11,7,8,2,1,7,11,63.6,4,5,0,5,2,13,4,0
153,Romain Del Castillo,FRA,MF|FW,Rennes,25,1996,0.3,2,1,0,1,1,2,2,100.0,0,0,0,0,1,3,0,0
154,Romain Del Castillo,FRA,MF|FW,Brest,25,1996,10.8,27,16,3,17,7,12,31,38.7,19,12,0,12,7,34,3,0
155,Thomas Delaine,FRA,DF,Metz,29,1992,25.7,48,35,34,12,2,22,42,52.4,20,20,7,13,27,75,31,0
156,Sacha Delaye,FRA,MF|FW,Montpellier,19,2002,2.9,8,6,3,2,3,2,8,25.0,6,1,0,1,1,9,1,1
157,Andy Delort,ALG,FW,Nice,29,1991,27.2,15,9,3,5,7,7,12,58.3,5,13,4,9,9,24,14,0
158,Andy Delort,ALG,FW,Montpellier,29,1991,3.0,2,0,0,1,1,0,1,0.0,1,1,0,1,0,2,4,0
159,Moussa Dembélé,FRA,FW,Lyon,25,1996,24.5,18,9,5,5,8,6,15,40.0,9,13,0,13,8,26,30,1
160,Jason Denayer,BEL,DF,Lyon,26,1995,11.1,11,4,8,3,0,6,7,85.7,1,8,7,1,16,27,52,0
161,Arthur Desmas,FRA,GK,Clermont Foot,27,1994,14.5,0,0,0,0,0,0,3,0.0,3,0,0,0,0,0,1,3
162,Ángel Di María,ARG,FW,Paris S-G,33,1988,18.3,29,18,6,13,10,14,37,37.8,23,17,0,17,6,35,3,0
163,Yadaly Diaby,GUI,FW|MF,Clermont Foot,20,2000,0.7,0,0,0,0,0,0,1,0.0,1,0,0,0,2,2,2,0
164,Ibrahim Diakité,GUI,MF,Reims,17,2003,0.0,0,0,0,0,0,0,1,0.0,1,0,0,0,0,0,0,0
165,Abdou Diallo,SEN,DF,Paris S-G,25,1996,9.7,22,14,10,9,3,8,14,57.1,6,6,2,4,10,32,19,1
166,Habib Diallo,SEN,FW,Strasbourg,26,1995,17.1,9,5,0,8,1,0,8,0.0,8,13,4,9,4,13,11,0
167,Mouhamadou Diarra,FRA,MF,Strasbourg,17,2004,1.2,2,1,1,1,0,1,1,100.0,0,0,0,0,0,2,0,0
168,Stéphane Diarra,FRA,MF|FW,Lorient,22,1998,5.8,11,9,7,3,1,5,10,50.0,5,4,0,4,7,18,1,0
169,Krépin Diatta,SEN,MF|DF,Monaco,22,1999,3.2,3,2,1,0,2,1,3,33.3,2,2,0,2,1,4,0,0
170,Bamba Dieng,SEN,FW,Marseille,21,2000,10.8,17,11,5,5,7,4,14,28.6,10,7,0,7,5,22,8,0
171,Elhadji Dieye,SEN,FW|MF,Saint-Étienne,19,2002,0.4,3,2,2,1,0,0,1,0.0,1,2,0,2,1,4,0,0
172,Javairô Dilrosun,NED,MF|FW,Bordeaux,23,1998,19.2,13,4,2,8,3,7,24,29.2,17,14,1,13,11,24,5,0
173,Junior Dina Ebimbe,FRA,MF,Paris S-G,20,2000,3.5,9,4,3,4,2,2,3,66.7,1,5,3,2,2,11,1,0
174,Tristan Dingomé,CMR,MF|FW,Troyes,30,1991,12.0,23,11,10,12,1,10,18,55.6,8,7,1,6,9,32,3,0
175,Sinaly Diomande,CIV,DF,Lyon,20,2001,6.4,6,3,4,2,0,5,6,83.3,1,6,6,0,12,18,26,0
176,Sofiane Diop,FRA,MF|FW,Monaco,21,2000,21.6,38,20,12,19,7,15,47,31.9,32,10,0,10,23,61,4,0
177,Andy Diouf,FRA,MF,Rennes,18,2003,0.2,1,1,1,0,0,1,1,100.0,0,1,0,1,0,1,0,0
178,Assane Dioussé,SEN,MF,Saint-Étienne,23,1997,0.3,1,1,1,0,0,1,1,100.0,0,0,0,0,0,1,0,0
179,Axel Disasi,FRA,DF,Monaco,23,1998,30.2,42,27,20,21,1,23,39,59.0,16,40,30,10,26,68,75,0
180,Tiago Djaló,POR,DF,Lille,21,2000,25.9,60,39,39,19,2,26,39,66.7,13,26,10,16,24,84,71,0
181,Alexander Djiku,GHA,DF,Strasbourg,26,1994,29.9,50,37,33,13,4,18,35,51.4,17,30,13,17,61,111,90,2
182,Bryan Djile Nokoué,CMR,DF|MF,Saint-Étienne,19,2002,0.6,3,3,1,2,0,2,2,100.0,0,1,0,1,1,4,2,0
183,Ouparine Djoco,GNB,GK,Clermont Foot,23,1998,23.5,0,0,0,0,0,0,0,,0,0,0,0,1,1,14,2
184,Jeremy Doku,BEL,FW|MF,Rennes,19,2002,5.2,10,5,3,5,2,3,6,50.0,3,4,0,4,3,13,0,0
185,Kasper Dolberg,DEN,FW,Nice,23,1997,16.6,9,4,4,3,2,3,9,33.3,6,15,1,14,6,15,17,0
186,Brandon Domingues,FRA,MF|FW,Troyes,21,2000,2.6,6,2,2,4,0,2,3,66.7,1,3,0,3,3,9,0,0
187,Anastasios Donis,GRE,FW|MF,Reims,24,1996,4.1,8,7,4,2,2,2,6,33.3,4,3,0,3,0,8,1,0
188,Gianluigi Donnarumma,ITA,GK,Paris S-G,22,1999,17.0,0,0,0,0,0,0,0,,0,0,0,0,0,0,9,2
189,Jodel Dossou,BEN,FW,Clermont Foot,29,1992,22.3,36,17,15,14,7,15,43,34.9,28,14,0,14,5,41,7,0
190,Lohann Doucet,FRA,MF|DF,Nantes,18,2002,0.1,0,0,0,0,0,0,0,,0,0,0,0,1,1,0,0
191,Cheick Doucouré,MLI,MF,Lens,21,2000,32.7,75,43,34,34,7,35,79,44.3,44,30,7,23,68,143,24,0
192,Fodé Doucouré,MLI,DF|FW,Reims,20,2001,1.7,12,9,9,3,0,9,11,81.8,2,1,0,1,4,16,6,0
193,Ismaël Doukouré,FRA,DF,Strasbourg,18,2003,0.2,0,0,0,0,0,0,0,,0,0,0,0,0,0,1,0
194,Kamory Doumbia,MLI,MF|FW,Reims,18,2003,3.9,8,2,2,5,1,5,13,38.5,8,9,3,6,3,11,3,0
195,Moussa Doumbia,MLI,FW,Reims,26,1994,1.0,0,0,0,0,0,0,1,0.0,1,0,0,0,0,0,0,0
196,Souleyman Doumbia,CIV,DF|FW,Angers,24,1996,24.7,30,20,16,9,5,13,27,48.1,14,25,4,21,39,69,51,0
197,Julian Draxler,GER,FW|MF,Paris S-G,27,1993,6.1,3,2,0,3,0,0,4,0.0,4,3,0,3,5,8,3,0
198,Matthieu Dreyer,FRA,GK,Lorient,32,1989,16.0,1,1,1,0,0,1,1,100.0,0,0,0,0,0,1,9,0
199,Leo Dubois,FRA,DF,Lyon,26,1994,19.4,43,27,22,14,7,27,46,58.7,19,27,3,24,22,65,35,1
200,Jean-Kevin Duverne,HAI,DF,Brest,24,1997,33.4,71,44,43,21,7,42,90,46.7,48,40,5,35,53,124,92,0
201,Enzo Ebosse,CMR,DF,Angers,22,1999,21.0,25,14,19,6,0,11,19,57.9,8,19,9,10,15,40,42,0
202,Hugo Ekitike,FRA,FW,Reims,19,2002,14.1,18,10,8,6,4,4,11,36.4,7,9,2,7,6,24,15,0
203,Alberth Elis,HON,FW|MF,Bordeaux,25,1996,15.7,19,10,5,5,9,11,25,44.0,14,9,0,9,7,26,10,0
204,Renaud Emond,BEL,FW|MF,Nantes,29,1991,2.1,1,0,0,1,0,0,4,0.0,4,2,1,1,0,1,1,0
205,Maxime Estève,FRA,DF,Montpellier,19,2002,20.6,27,18,22,4,1,15,27,55.6,12,31,24,7,22,49,69,1
206,Fábio,BRA,DF,Nantes,31,1990,18.5,61,40,31,23,7,36,74,48.6,38,29,7,22,35,96,31,1
207,Cesc Fàbregas,ESP,MF,Monaco,34,1987,0.4,1,0,0,1,0,1,1,100.0,0,0,0,0,1,2,0,0
208,Wout Faes,BEL,DF,Reims,23,1998,37.0,40,24,30,9,1,25,33,75.8,8,47,37,10,53,93,169,2
209,Romain Faivre,FRA,FW|MF,Lyon,23,1998,9.9,10,4,2,6,2,4,13,30.8,9,4,0,4,3,13,2,0
210,Romain Faivre,FRA,MF,Brest,23,1998,19.9,30,18,12,13,5,12,30,40.0,18,11,0,11,13,43,10,0
211,Wuilker Faríñez,VEN,GK,Lens,23,1998,12.3,0,0,0,0,0,0,0,,0,0,0,0,0,0,4,0
212,Noah Fatar,FRA,DF|MF,Angers,19,2002,0.1,1,0,0,0,1,0,1,0.0,1,0,0,0,1,2,0,0
213,Julien Faussurier,FRA,MF|DF,Brest,34,1987,5.4,10,6,3,3,4,6,13,46.2,7,12,1,11,5,15,6,0
214,Jordan Ferri,FRA,MF,Montpellier,29,1992,32.3,55,35,28,23,4,29,87,33.3,58,21,5,16,30,85,35,0
215,Karol Fila,POL,DF,Strasbourg,23,1998,6.2,10,8,5,4,1,4,8,50.0,4,7,2,5,4,14,6,0
216,Alexis Flips,FRA,MF|DF,Reims,21,2000,11.7,37,21,21,9,7,22,45,48.9,23,21,0,21,24,61,17,0
217,Mamadou Fofana,MLI,DF,Metz,23,1998,0.4,1,1,0,1,0,1,2,50.0,1,2,1,1,1,2,2,0
218,Seko Fofana,CIV,MF,Lens,26,1995,37.3,27,19,11,13,3,12,58,20.7,46,24,2,22,26,53,17,1
219,Youssouf Fofana,FRA,MF,Monaco,22,1999,24.3,69,43,19,41,9,29,56,51.8,27,29,7,22,32,101,22,2
220,Thomas Foket,BEL,DF|FW,Reims,26,1994,24.8,28,19,12,13,3,18,40,45.0,22,26,4,22,33,61,35,0
221,Thomas Fontaine,MAD,DF,Lorient,30,1991,1.9,2,0,1,0,1,0,1,0.0,1,3,3,0,2,4,4,0
222,José Fonte,POR,DF,Lille,37,1983,38.0,23,12,14,7,2,11,25,44.0,14,39,32,7,44,67,159,1
223,Steven Fortes,CPV,DF,Lens,29,1992,1.0,2,0,2,0,0,1,2,50.0,1,2,1,1,0,2,4,0
224,Przemysław Frankowski,POL,DF,Lens,26,1995,27.2,57,39,22,27,8,36,74,48.6,38,27,0,27,28,85,52,0
225,Fransérgio,BRA,MF,Bordeaux,30,1990,14.0,24,10,8,12,4,12,43,27.9,31,18,6,12,23,47,23,0
226,Angelo Fulgini,FRA,MF|FW,Angers,24,1996,32.5,35,25,8,18,9,14,44,31.8,30,21,5,16,22,57,5,1
227,Gauthier Gallon,FRA,GK,Troyes,28,1993,31.0,3,0,3,0,0,1,1,100.0,0,0,0,0,2,5,12,1
228,Kévin Gameiro,FRA,FW,Strasbourg,34,1987,26.5,19,10,5,9,5,6,18,33.3,12,22,1,21,6,25,1,0
229,Idrissa Gana Gueye,SEN,MF,Paris S-G,31,1989,18.2,60,36,24,24,12,18,44,40.9,26,23,4,19,24,84,13,0
230,Ignatius Ganago,CMR,FW,Lens,22,1999,11.4,3,2,1,2,0,2,6,33.3,4,4,0,4,2,5,3,0
231,Djeidi Gassama,FRA,FW,Paris S-G,17,2003,0.0,0,0,0,0,0,0,0,,0,1,1,0,0,0,0,0
232,Johan Gastien,FRA,MF,Clermont Foot,33,1988,30.5,56,34,26,25,5,27,74,36.5,47,45,11,34,53,109,49,1
233,Valère Germain,FRA,FW,Montpellier,31,1990,21.9,23,14,6,11,6,8,31,25.8,23,13,1,12,9,32,27,0
234,Gerson,BRA,MF|FW,Marseille,24,1997,28.3,42,17,16,20,6,8,35,22.9,27,26,4,22,16,58,16,2
235,Willem Geubbels,FRA,FW|MF,Nantes,19,2001,6.0,8,5,4,2,2,5,12,41.7,7,5,0,5,6,14,5,0
236,Ismaël Gharbi,ESP,FW,Paris S-G,17,2004,0.0,0,0,0,0,0,0,0,,0,0,0,0,0,0,0,0
237,Lamine Ghezali,FRA,DF,Saint-Étienne,22,1999,0.0,0,0,0,0,0,0,0,,0,1,0,1,0,0,0,0
238,Nicholas Gioacchini,USA,FW|MF,Montpellier,21,2000,5.5,7,5,3,2,2,4,10,40.0,6,8,0,8,4,11,5,0
239,Jimmy Giraudon,FRA,DF,Troyes,29,1992,18.0,14,6,10,4,0,7,22,31.8,15,24,14,10,37,51,68,1
240,Andrei Girotto,BRA,DF|MF,Nantes,29,1992,35.0,85,52,49,32,4,52,103,50.5,51,67,33,34,69,154,143,0
241,Aleksandr Golovin,RUS,FW|MF,Monaco,25,1996,16.7,40,22,10,18,12,18,41,43.9,23,26,1,25,12,52,8,0
242,Angel Gomes,ENG,MF|FW,Lille,20,2000,10.6,23,13,6,12,5,10,15,66.7,5,4,0,4,3,26,4,0
243,Alfred Gomis,SEN,GK,Rennes,27,1993,25.0,1,0,1,0,0,1,2,50.0,1,0,0,0,1,2,8,2
244,Vagner Gonçalves,CPV,FW,Metz,25,1996,1.0,2,1,0,2,0,1,1,100.0,0,0,0,0,1,3,0,0
245,Álvaro González,ESP,DF,Marseille,31,1990,5.0,1,1,1,0,0,1,1,100.0,0,0,0,0,1,2,9,0
246,Amine Gouiri,ALG,FW|MF,Nice,21,2000,30.6,22,13,2,13,7,10,32,31.3,22,22,5,17,11,33,17,1
247,Lucas Gourna-Douath,FRA,MF,Saint-Étienne,17,2003,20.0,45,26,22,18,5,21,36,58.3,15,22,3,19,13,58,9,2
248,Jonathan Gradit,FRA,DF,Lens,28,1992,34.1,60,28,24,28,8,25,45,55.6,20,39,27,12,65,125,106,0
249,Andrew Gravillon,GLP,DF,Reims,23,1998,23.7,32,24,19,13,0,17,27,63.0,10,25,15,10,33,65,83,1
250,Adrian Grbić,AUT,FW|MF,Lorient,24,1996,5.8,2,1,0,2,0,2,6,33.3,4,3,1,2,0,2,7,0
251,Ivo Grbić,CRO,GK,Lille,25,1996,21.0,0,0,0,0,0,0,0,,0,0,0,0,0,0,14,1
252,Etienne Green,ENG,GK,Saint-Étienne,21,2000,13.3,1,1,1,0,0,0,0,,0,0,0,0,1,2,9,0
253,Gabriel Gudmundsson,SWE,DF|MF,Lille,22,1999,14.9,43,31,24,16,3,17,35,48.6,18,15,3,12,20,63,13,0
254,Noah Guede-Nadje,FRA,MF,Angers,17,2003,0.0,0,0,0,0,0,0,0,,0,0,0,0,0,0,0,0
255,Mattéo Guendouzi,FRA,MF,Marseille,22,1999,35.0,45,30,10,26,9,13,47,27.7,34,15,1,14,16,61,18,0
256,Yanis Guermouche,FRA,MF|FW,Montpellier,20,2001,0.1,2,1,0,1,1,1,1,100.0,0,0,0,0,0,2,0,0
257,Evann Guessand,FRA,FW,Nice,20,2001,4.9,9,8,2,5,2,3,8,37.5,5,4,0,4,0,9,1,0
258,Lamine Gueye,SEN,FW|MF,Metz,23,1998,6.2,5,5,1,1,3,3,7,42.9,4,4,0,4,6,11,1,0
259,Pape Gueye,SEN,MF,Marseille,22,1999,17.0,38,19,15,22,1,16,31,51.6,15,15,3,12,24,62,16,0
260,Josuha Guilavogui,FRA,MF|DF,Bordeaux,30,1990,14.8,39,16,18,17,4,14,29,48.3,15,16,8,8,36,75,23,0
261,Frederic Guilbert,FRA,DF,Strasbourg,26,1994,28.0,69,39,33,24,12,32,62,51.6,30,37,11,26,55,124,39,0
262,Bruno Guimarães,BRA,MF,Lyon,23,1997,18.2,50,31,20,25,5,23,59,39.0,36,21,4,17,21,71,11,1
263,Serhou Guirassy,GUI,FW,Rennes,25,1996,11.3,4,2,1,2,1,1,7,14.3,6,4,0,4,1,5,8,0
264,Malo Gusto,FRA,DF,Lyon,18,2003,20.9,55,35,29,21,5,24,40,60.0,16,21,6,15,33,88,41,1
265,Massadio Haïdara,MLI,DF,Lens,28,1992,12.0,28,21,18,7,3,15,24,62.5,9,18,4,14,22,50,31,0
266,Oualid El Hajjam,MAR,DF,Troyes,30,1991,11.9,22,11,12,6,4,15,23,65.2,8,12,6,6,22,44,28,0
267,Achraf Hakimi,MAR,DF,Paris S-G,22,1998,27.5,74,51,38,27,9,40,72,55.6,32,26,5,21,28,102,23,2
268,Pierre-Yves Hamel,FRA,FW|MF,Lorient,27,1994,0.3,0,0,0,0,0,0,1,0.0,1,0,0,0,2,2,0,0
269,Pierre-Yves Hamel,FRA,FW,Clermont Foot,27,1994,5.8,11,6,0,5,6,5,6,83.3,1,2,1,1,0,11,0,0
270,Romain Hamouma,FRA,FW|MF,Saint-Étienne,34,1987,9.8,10,7,1,5,4,2,13,15.4,11,8,0,8,4,14,1,0
271,Amine Harit,MAR,FW|MF,Marseille,24,1997,12.9,18,11,9,9,0,9,17,52.9,8,10,0,10,4,22,2,0
272,Henrique,BRA,DF,Lyon,27,1994,12.3,13,7,10,1,2,5,16,31.3,11,13,1,12,22,35,14,0
273,Luis Henrique,BRA,FW|MF,Marseille,19,2001,7.8,4,3,2,1,1,2,5,40.0,3,2,0,2,5,9,1,0
274,Christophe Hérelle,MTQ,DF,Brest,28,1992,21.5,48,28,30,16,2,17,26,65.4,9,20,15,5,44,92,84,1
275,Jérôme Hergault,FRA,DF,Lorient,35,1986,3.9,3,1,1,2,0,2,5,40.0,3,4,1,3,4,7,7,0
276,Ander Herrera,ESP,MF,Paris S-G,31,1989,12.1,29,17,7,16,6,14,39,35.9,25,22,8,14,14,43,8,0
277,Franck Honorat,FRA,FW|MF,Brest,24,1996,32.2,54,38,25,13,16,27,47,57.4,20,24,2,22,15,69,25,0
278,Fraser Hornby,SCO,FW|MF,Reims,21,1999,3.9,3,1,1,2,0,0,2,0.0,2,3,0,3,4,7,5,0
279,Cédric Hountondji,BEN,DF,Clermont Foot,27,1994,22.6,33,17,20,12,1,16,24,66.7,8,23,12,11,34,67,76,0
280,Suk Hyun-jun,KOR,FW|MF,Troyes,30,1991,1.7,0,0,0,0,0,0,0,,0,2,0,2,0,0,2,0
281,Mauro Icardi,ARG,FW,Paris S-G,28,1993,11.4,5,3,1,3,1,3,7,42.9,4,3,0,3,5,10,12,0
282,Jonathan Iglesias,URU,MF,Clermont Foot,32,1988,6.4,18,11,6,10,2,10,18,55.6,8,8,2,6,5,23,2,1
283,Juan Ignacio Ramírez,URU,FW,Saint-Étienne,24,1997,1.4,2,1,0,1,1,0,0,,0,0,0,0,0,2,0,0
284,Danylo Ihnatenko,UKR,MF,Bordeaux,24,1997,7.7,17,9,8,7,2,10,24,41.7,14,9,2,7,6,23,17,1
285,Jonathan Ikone,FRA,MF|FW,Lille,23,1998,11.8,11,3,6,4,1,4,11,36.4,7,13,1,12,5,16,4,0
286,Bonke Innocent,NGA,MF,Lorient,25,1996,9.7,27,16,10,16,1,11,26,42.3,15,11,3,8,16,43,14,0
287,Wilson Isidor,FRA,FW|MF,Monaco,20,2000,0.6,0,0,0,0,0,0,4,0.0,4,1,0,1,0,0,0,0
288,Ismail Jakobs,SEN,DF|FW,Monaco,21,1999,13.4,32,16,14,15,3,16,35,45.7,19,16,1,15,17,49,31,0
289,Marin Jakoliš,CRO,FW,Angers,24,1996,2.5,2,1,0,1,1,0,6,0.0,6,0,0,0,1,3,0,0
290,Abdel Jalil Medioub,ALG,DF,Bordeaux,23,1997,6.9,9,5,5,3,1,3,4,75.0,1,8,4,4,12,21,34,0
291,Léo Jardim,BRA,GK,Lille,26,1995,17.0,0,0,0,0,0,0,0,,0,0,0,0,1,1,10,0
292,Corentin Jean,FRA,FW|MF,Lens,26,1995,2.8,9,6,4,4,1,3,6,50.0,3,5,0,5,1,10,0,0
293,Jemerson,BRA,DF,Metz,28,1992,13.4,37,25,30,7,0,18,26,69.2,8,23,8,15,25,62,33,1
294,Moritz Jenz,GER,DF,Lorient,22,1999,15.3,26,12,18,6,2,11,24,45.8,13,19,11,8,28,54,55,0
295,Lenny Joseph,FRA,FW|MF,Metz,20,2000,1.7,2,1,1,1,0,0,0,,0,3,0,3,0,2,0,0
296,Issa Kaboré,BFA,DF,Troyes,20,2001,25.0,45,22,22,14,9,20,38,52.6,18,27,2,25,20,65,38,1
297,Tino Kadewere,ZIM,FW,Lyon,25,1996,5.6,7,5,2,2,3,4,13,30.8,9,7,0,7,4,11,1,1
298,Gaël Kakuta,COD,MF|FW,Lens,30,1991,18.6,22,14,2,13,7,4,20,20.0,16,10,0,10,4,26,3,0
299,Arnaud Kalimuendo,FRA,FW,Lens,19,2002,23.9,9,8,1,3,5,2,7,28.6,5,6,1,5,8,17,0,0
300,Arnaud Kalimuendo,FRA,FW,Paris S-G,19,2002,0.1,0,0,0,0,0,0,0,,0,0,0,0,0,0,0,0
301,Samuel Kalu,NGA,FW|MF,Bordeaux,23,1997,3.6,8,5,3,4,1,2,5,40.0,3,2,0,2,3,11,1,0
302,Boubacar Kamara,FRA,MF|DF,Marseille,21,1999,30.9,68,38,27,36,5,26,47,55.3,21,29,10,19,46,114,44,1
303,Hassane Kamara,CIV,MF|DF,Nice,27,1994,6.0,13,10,4,6,3,5,8,62.5,3,10,2,8,9,22,4,0
304,Jean-Armel Kana-Biyik,CMR,DF,Metz,32,1989,7.4,10,6,8,2,0,4,9,44.4,5,11,4,7,16,26,22,1
305,Nordine Kandil,FRA,MF|FW,Strasbourg,19,2001,1.0,2,1,2,0,0,1,1,100.0,0,1,1,0,0,2,0,0
306,Eiji Kawashima,JPN,GK,Strasbourg,38,1983,1.0,0,0,0,0,0,0,0,,0,0,0,0,0,0,0,0
307,Ilan Kebbal,ALG,MF|FW,Reims,23,1998,19.7,31,15,13,10,8,12,44,27.3,32,16,0,16,13,44,3,0
308,Thilo Kehrer,GER,DF,Paris S-G,24,1996,16.8,21,14,9,11,1,9,21,42.9,12,19,11,8,24,45,29,0
309,Habib Keita,MLI,MF|FW,Lyon,19,2002,0.1,0,0,0,0,0,0,0,,0,0,0,0,0,0,0,0
310,Saîf-Eddine Khaoui,TUN,MF|FW,Clermont Foot,26,1995,10.3,19,10,5,10,4,9,18,50.0,9,9,0,9,14,33,5,0
311,Wahbi Khazri,TUN,FW|MF,Saint-Étienne,30,1991,24.7,33,18,7,17,9,9,34,26.5,25,21,0,21,12,45,7,0
312,Presnel Kimpembe,FRA,DF,Paris S-G,25,1995,28.6,34,19,18,15,1,14,23,60.9,9,20,14,6,38,72,73,1
313,Thibault Klidje,TOG,MF|FW,Bordeaux,20,2001,1.0,0,0,0,0,0,0,1,0.0,1,1,1,0,2,2,0,0
314,Justin Kluivert,NED,MF,Nice,22,1999,20.8,19,9,6,12,1,5,21,23.8,16,13,1,12,14,33,6,0
315,Samuel Koeberlé,FRA,FW,Reims,16,2004,0.0,0,0,0,0,0,0,0,,0,0,0,0,0,0,0,0
316,Philippe Koffi,CIV,FW,Reims,19,2002,4.2,4,0,0,3,1,0,2,0.0,2,2,1,1,3,7,3,0
317,Sead Kolašinac,BIH,DF,Marseille,28,1993,4.9,7,6,2,3,2,5,8,62.5,3,4,0,4,0,7,7,1
318,Randal Kolo Muani,FRA,FW|MF,Nantes,22,1998,32.8,28,14,7,10,11,10,25,40.0,15,14,3,11,6,34,31,0
319,Timothée Kolodziejczak,FRA,DF,Saint-Étienne,29,1991,28.5,43,24,22,14,7,20,36,55.6,16,29,7,22,60,103,72,1
320,Ghislain Konan,CIV,DF,Reims,25,1995,26.9,35,19,19,15,1,16,30,53.3,14,35,8,27,28,63,45,0
321,Ibrahima Koné,MLI,FW,Lorient,22,1999,8.1,7,4,0,3,4,2,3,66.7,1,8,3,5,1,8,3,0
322,Youssouf Koné,MLI,DF,Troyes,26,1995,10.9,30,18,21,8,1,19,30,63.3,11,8,3,5,10,40,25,0
323,Laurent Koscielny,FRA,DF,Bordeaux,35,1985,10.4,14,9,10,3,1,8,13,61.5,5,17,12,5,12,26,39,0
324,Rominigue Kouamé,MLI,MF,Troyes,24,1996,33.0,47,22,24,20,3,19,58,32.8,39,33,5,28,46,93,22,2
325,Boubakar Kouyaté,MLI,DF,Metz,24,1997,29.6,84,50,56,28,0,48,77,62.3,29,63,33,30,79,163,217,3
326,Jean-Philippe Krasso,CIV,FW,Saint-Étienne,24,1997,5.0,7,5,0,5,2,2,10,20.0,8,7,1,6,0,7,1,0
327,Mykola Kukharevych,UKR,FW,Troyes,20,2001,0.2,0,0,0,0,0,0,0,,0,0,0,0,0,0,0,0
328,Enock Kwateng,FRA,DF,Bordeaux,24,1997,22.2,54,35,31,19,4,33,72,45.8,39,17,4,13,43,97,48,1
329,Grejohn Kyei,FRA,FW,Clermont Foot,25,1995,4.4,3,2,1,1,1,0,6,0.0,6,6,0,6,0,3,1,0
330,Gaëtan Laborde,FRA,FW,Montpellier,27,1994,3.8,2,2,1,1,0,2,4,50.0,2,3,0,3,5,7,5,0
331,Gaëtan Laborde,FRA,FW,Rennes,27,1994,30.3,19,7,5,8,6,3,22,13.6,19,29,3,26,8,27,16,0
332,Tom Lacoux,FRA,DF|MF,Bordeaux,19,2002,10.1,18,13,11,5,2,9,24,37.5,15,14,4,10,9,27,20,1
333,Lenny Lacroix,FRA,DF,Metz,18,2003,2.2,9,7,8,1,0,5,8,62.5,3,5,1,4,10,19,5,0
334,Alban Lafont,FRA,GK,Nantes,22,1999,38.0,3,3,3,0,0,3,8,37.5,5,1,0,1,1,4,25,2
335,Mohamed Lamine Bayo,GUI,FW,Clermont Foot,23,1998,26.8,12,5,4,3,5,3,24,12.5,21,7,1,6,7,19,14,0
336,Didier Lamkel Zé,CMR,FW,Metz,24,1996,6.7,3,1,1,0,2,1,3,33.3,2,3,1,2,1,4,7,0
337,Julien Laporte,FRA,DF,Lorient,27,1993,32.1,63,45,35,26,2,32,64,50.0,32,37,22,15,54,117,174,0
338,Yasser Larouci,ALG,DF,Troyes,20,2001,3.8,6,5,2,4,0,3,3,100.0,0,1,0,1,7,13,5,0
339,Paul Lasne,FRA,MF,Brest,32,1989,9.4,26,12,6,16,4,8,18,44.4,10,11,2,9,24,50,10,0
340,Armand Lauriente,FRA,FW|MF,Lorient,22,1998,27.5,33,18,9,16,8,11,30,36.7,19,27,2,25,15,48,3,0
341,Théo Le Bris,FRA,MF,Lorient,18,2002,0.7,2,1,1,1,0,1,2,50.0,1,2,0,2,0,2,1,0
342,Jérémy Le Douaron,FRA,FW|MF,Brest,23,1998,16.1,11,5,4,4,3,1,17,5.9,16,15,0,15,4,15,14,0
343,Enzo Le Fée,FRA,MF|FW,Lorient,21,2000,24.4,70,44,25,36,9,41,90,45.6,49,25,1,24,29,99,18,0
344,Vincent Le Goff,FRA,DF,Lorient,31,1989,34.0,61,38,38,19,4,37,62,59.7,25,18,3,15,37,98,50,0
345,Maxime Le Marchand,FRA,DF,Strasbourg,31,1989,9.6,17,8,16,1,0,8,10,80.0,2,9,5,4,14,31,32,0
346,Jean-Louis Leca,FRA,GK,Lens,35,1985,25.7,0,0,0,0,0,0,0,,0,1,0,1,1,1,11,1
347,Félix Lemaréchal,FRA,MF,Monaco,17,2003,0.1,0,0,0,0,0,0,1,0.0,1,0,0,0,0,0,0,0
348,Mario Lemina,GAB,MF,Nice,27,1993,21.9,62,35,25,33,4,28,38,73.7,10,32,9,23,48,110,37,0
349,Fabien Lemoine,FRA,MF,Lorient,34,1987,12.4,35,22,20,14,1,17,41,41.5,24,21,4,17,14,49,24,1
350,Léo Leroy,FRA,MF,Montpellier,21,2000,7.0,31,21,17,11,3,12,34,35.3,22,20,4,16,8,39,8,0
351,Alexandre Letellier,FRA,GK,Paris S-G,30,1990,0.1,0,0,0,0,0,0,0,,0,0,0,0,0,0,0,0
352,Yanis Lhery,FRA,FW|MF,Saint-Étienne,18,2003,0.8,0,0,0,0,0,0,0,,0,4,0,4,0,0,0,0
353,Dimitri Liénard,FRA,DF|MF,Strasbourg,33,1988,22.7,71,43,40,21,10,46,77,59.7,31,12,0,12,21,92,28,0
354,Isaac Lihadji,FRA,MF|FW,Lille,19,2002,2.6,3,3,1,1,1,1,5,20.0,4,1,0,1,2,5,0,0
355,Pol Lirola,ESP,DF|FW,Marseille,23,1997,19.7,28,16,15,9,4,13,28,46.4,15,15,0,15,13,41,22,0
356,Bradley Locko,FRA,MF|DF,Reims,19,2002,11.2,28,19,13,11,4,14,24,58.3,10,20,8,12,14,42,15,0
357,Anthony Lopes,POR,GK,Lyon,30,1990,33.1,0,0,0,0,0,0,0,,0,0,0,0,3,3,12,3
358,Pau López,ESP,GK,Marseille,26,1994,29.0,0,0,0,0,0,0,1,0.0,1,0,0,0,0,0,12,1
359,Dion Lopy,SEN,MF,Reims,19,2002,18.2,53,29,22,24,7,21,53,39.6,32,20,4,16,22,75,17,0
360,Samuel Loric,FRA,DF,Lorient,21,2000,3.0,7,5,2,3,2,5,8,62.5,3,2,0,2,5,12,9,0
361,Jordan Lotomba,SUI,DF,Nice,22,1998,19.8,33,17,21,9,3,16,30,53.3,14,17,4,13,12,45,28,0
362,Johaneko Louisjean,FRA,DF,Bordeaux,17,2004,0.1,0,0,0,0,0,0,0,,0,0,0,0,0,0,0,0
363,Jean Lucas,BRA,MF,Monaco,23,1998,16.1,43,25,14,24,5,17,40,42.5,23,15,5,10,13,56,4,1
364,Castello Lukeba,FRA,DF,Lyon,18,2002,23.3,34,19,27,7,0,15,23,65.2,8,18,9,9,38,72,64,2
365,Levi Lumeka,ENG,MF|FW,Troyes,22,1998,0.7,0,0,0,0,0,0,2,0.0,2,0,0,0,0,0,2,0
366,Yannis M'Bemba,FRA,DF|FW,Nantes,20,2001,0.1,0,0,0,0,0,0,0,,0,0,0,0,0,0,1,0
367,Deiver Machado,COL,DF|MF,Lens,27,1993,5.8,16,14,11,1,4,12,14,85.7,2,9,1,8,3,19,12,1
368,Yvann Macon,FRA,DF,Saint-Étienne,22,1998,17.0,41,22,24,14,3,16,42,38.1,26,18,4,14,18,59,27,0
369,Louis Mafouta,CTA,FW,Metz,27,1994,5.8,0,0,0,0,0,0,5,0.0,5,1,0,1,0,0,4,0
370,Hugo Magnetti,FRA,MF,Brest,23,1998,16.3,50,34,27,20,3,22,50,44.0,28,14,3,11,25,75,13,0
371,Yohann Magnin,FRA,MF|DF,Clermont Foot,24,1997,19.1,53,31,22,26,5,24,42,57.1,18,17,7,10,20,73,36,0
372,Habib Maïga,CIV,MF,Metz,25,1996,14.1,47,28,29,13,5,24,48,50.0,24,20,7,13,14,61,18,0
373,Josh Maja,NGA,FW,Bordeaux,22,1998,0.1,0,0,0,0,0,0,0,,0,1,0,1,0,0,0,0
374,Abdul Majeed Waris,GHA,FW|MF,Strasbourg,29,1991,3.6,5,3,2,3,0,5,10,50.0,5,2,0,2,0,5,1,0
375,Lovro Majer,CRO,MF|FW,Rennes,23,1998,20.4,32,21,9,14,9,11,42,26.2,31,26,2,24,11,43,9,0
376,Béni Makouana,CGO,FW|MF,Montpellier,18,2002,3.6,2,2,0,0,2,0,1,0.0,1,1,0,1,3,5,2,0
377,Hianga Mananga Mbock,FRA,MF,Brest,21,1999,8.9,18,12,8,7,3,9,21,42.9,12,5,2,3,5,23,6,0
378,Vincent Manceau,FRA,DF,Angers,32,1989,26.2,32,19,18,13,1,14,37,37.8,23,23,6,17,32,64,72,0
379,Steve Mandanda,FRA,GK,Marseille,36,1985,9.0,0,0,0,0,0,0,1,0.0,1,1,0,1,1,1,4,1
380,Reinildo Mandava,MOZ,DF,Lille,27,1994,16.9,43,23,29,11,3,32,51,62.7,19,13,4,9,37,80,55,0
381,Anthony Mandrea,ALG,GK,Angers,24,1996,10.0,0,0,0,0,0,0,0,,0,0,0,0,0,0,9,0
382,Eliaquim Mangala,FRA,DF,Saint-Étienne,30,1991,13.1,17,12,12,5,0,8,12,66.7,4,11,8,3,17,34,61,1
383,Thomas Mangani,FRA,MF,Angers,34,1987,24.4,58,30,23,34,1,31,68,45.6,37,38,11,27,36,94,29,0
384,Ricardo Mangas,POR,DF,Bordeaux,23,1998,26.1,35,22,22,8,5,26,41,63.4,15,18,4,14,25,60,47,3
385,Myziane Maolida,COM,MF,Nice,22,1999,0.4,1,0,0,1,0,0,0,,0,1,0,1,0,1,0,0
386,Sekou Mara,FRA,FW|MF,Bordeaux,19,2002,10.1,8,4,1,1,6,1,8,12.5,7,7,0,7,2,10,6,0
387,Marcelo,BRA,DF,Bordeaux,34,1987,10.0,9,5,7,2,0,4,6,66.7,2,4,3,1,13,22,46,1
388,Marcelo,BRA,DF,Lyon,34,1987,2.0,4,3,0,4,0,4,6,66.7,2,3,2,1,4,8,10,0
389,Guillermo Maripán,CHI,DF,Monaco,27,1994,20.4,36,24,27,9,0,20,40,50.0,20,21,14,7,25,61,66,1
390,Marquinhos,BRA,DF,Paris S-G,27,1994,31.8,37,14,25,11,1,20,35,57.1,15,35,19,16,16,53,102,0
391,Jonas Martin,FRA,MF,Rennes,31,1990,23.4,35,20,12,21,2,19,53,35.8,34,17,3,14,22,57,28,1
392,Gelson Martins,POR,MF|FW,Monaco,26,1995,21.2,42,27,10,26,6,21,59,35.6,38,26,1,25,17,59,4,0
393,Pape Matar Sarr,SEN,MF,Metz,18,2002,23.7,45,26,21,23,1,18,39,46.2,21,33,3,30,29,74,22,0
394,Eliot Matazo,BEL,MF,Monaco,19,2002,8.8,8,7,4,4,0,2,11,18.2,9,11,3,8,13,21,9,0
395,Chrislain Matsima,FRA,DF,Monaco,19,2002,1.5,3,2,1,2,0,2,7,28.6,5,3,3,0,1,4,6,1
396,Azor Matusiwa,NED,MF,Reims,23,1998,27.4,58,32,28,26,4,26,55,47.3,29,49,19,30,62,120,43,0
397,Stephy Mavididi,ENG,FW|MF,Montpellier,23,1998,25.5,24,13,11,7,6,14,39,35.9,25,23,2,21,8,32,11,0
398,Derek Mazou-Sacko,FRA,FW|DF,Troyes,16,2004,0.0,1,0,0,0,1,1,1,100.0,0,0,0,0,0,1,1,0
399,Kylian Mbappé,FRA,FW,Paris S-G,22,1998,33.6,11,8,1,4,6,7,13,53.8,6,6,0,6,5,16,13,0
400,Amadou Mbengue,SEN,DF|MF,Metz,19,2002,6.8,19,10,10,9,0,11,22,50.0,11,7,2,5,10,29,19,0
401,Jason Mbock,FRA,FW,Angers,21,1999,0.2,0,0,0,0,0,0,0,,0,0,0,0,0,0,0,0
402,Moustapha Mbow,SEN,DF,Reims,21,2000,1.0,6,6,3,2,1,3,3,100.0,0,0,0,0,1,7,6,0
403,Nathanael Mbuku,FRA,FW|MF,Reims,19,2002,15.8,14,13,4,7,3,2,8,25.0,6,14,0,14,11,25,4,0
404,Facundo Medina,ARG,DF,Lens,22,1999,28.8,61,42,34,23,4,38,62,61.3,24,24,8,16,37,98,78,3
405,Farid El Melali,ALG,FW,Angers,24,1997,0.2,0,0,0,0,0,0,1,0.0,1,1,0,1,0,0,1,0
406,Birger Meling,NOR,DF,Rennes,26,1994,20.3,43,27,25,11,7,23,31,74.2,8,23,7,16,22,65,40,0
407,Houboulang Mendes,GNB,DF,Lorient,23,1998,35.8,58,28,37,18,3,40,57,70.2,17,41,21,20,41,99,128,4
408,Nuno Mendes,POR,DF,Paris S-G,19,2002,18.4,48,29,23,18,7,25,47,53.2,22,27,5,22,21,69,17,1
409,Pedro Mendes,POR,DF,Montpellier,30,1990,0.2,1,1,1,0,0,0,0,,0,1,1,0,0,1,2,0
410,Thiago Mendes,BRA,MF|DF,Lyon,29,1992,20.7,36,22,18,16,2,12,30,40.0,18,24,5,19,34,70,56,1
411,Arial Mendy,SEN,DF|FW,Clermont Foot,26,1994,8.8,6,4,4,2,0,2,11,18.2,9,6,1,5,7,13,17,0
412,Batista Mendy,FRA,MF|DF,Angers,21,2000,26.8,49,28,21,22,6,23,45,51.1,22,37,6,31,34,83,40,0
413,Gideon Mensah,GHA,DF,Bordeaux,23,1998,13.4,37,24,19,12,6,18,38,47.4,20,11,2,9,16,53,21,0
414,Quentin Merlin,FRA,DF|MF,Nantes,19,2002,21.4,45,28,19,20,6,26,49,53.1,23,25,4,21,27,72,29,2
415,Lionel Messi,ARG,FW|MF,Paris S-G,34,1987,23.9,10,3,1,5,4,3,13,23.1,10,5,0,5,4,14,0,0
416,Mexer,MOZ,DF,Bordeaux,32,1988,13.6,14,10,11,3,0,11,17,64.7,6,12,7,5,21,35,60,2
417,Edouard Michut,FRA,MF,Paris S-G,18,2003,0.8,0,0,0,0,0,0,2,0.0,2,2,0,2,1,1,2,0
418,Georges Mikautadze,GEO,FW,Metz,20,2000,0.0,0,0,0,0,0,0,0,,0,0,0,0,0,0,0,0
419,William Mikelbrencis,FRA,DF,Metz,17,2004,6.8,11,5,6,4,1,6,9,66.7,3,6,3,3,5,16,9,0
420,Arkadiusz Milik,POL,FW,Marseille,27,1994,15.7,9,2,0,5,4,4,18,22.2,14,9,1,8,3,12,10,1
421,Terem Moffi,NGA,FW,Lorient,22,1999,30.1,17,10,3,12,2,9,32,28.1,23,11,2,9,4,21,22,0
422,Dion Moise Sahi,CIV,FW|MF,Strasbourg,19,2001,1.4,0,0,0,0,0,0,0,,0,1,0,1,1,1,1,0
423,Florent Mollet,FRA,FW|MF,Montpellier,29,1991,29.2,31,22,14,12,5,14,57,24.6,43,27,4,23,24,55,13,0
424,Thomas Monconduit,FRA,MF,Lorient,30,1991,25.0,41,25,19,17,5,20,57,35.1,37,21,10,11,22,63,51,1
425,Jérémy Morel,MAD,DF,Lorient,37,1984,6.7,13,9,8,4,1,6,6,100.0,0,9,7,2,7,20,31,0
426,Lebo Mothiba,RSA,FW|MF,Troyes,25,1996,5.8,8,4,4,3,1,2,5,40.0,3,3,0,3,2,10,0,0
427,Lebo Mothiba,RSA,FW,Strasbourg,25,1996,0.0,0,0,0,0,0,0,0,,0,0,0,0,0,0,0,0
428,Baptiste Mouazan,FRA,MF,Lorient,19,2001,1.1,4,3,2,2,0,1,3,33.3,2,3,0,3,1,5,1,0
429,Aimen Moueffek,FRA,MF,Saint-Étienne,20,2001,4.8,7,4,2,3,2,2,8,25.0,6,3,0,3,2,9,4,0
430,Harold Moukoudi,CMR,DF,Saint-Étienne,23,1997,18.5,25,12,17,8,0,14,25,56.0,11,27,14,13,35,60,48,0
431,Jessy Moulin,FRA,GK,Troyes,35,1986,7.0,0,0,0,0,0,0,0,,0,0,0,0,1,1,7,0
432,Steve Mounié,BEN,FW,Brest,26,1994,25.7,17,6,3,12,2,4,27,14.8,23,13,1,12,6,23,12,0
433,Samuel Moutoussamy,COD,MF,Nantes,24,1996,16.8,48,32,20,20,8,23,62,37.1,39,14,2,12,17,65,16,0
434,Marshall Munetsi,ZIM,MF|DF,Reims,25,1996,20.9,34,17,21,11,2,17,39,43.6,22,39,13,26,43,77,72,2
435,Junior Mwanga,FRA,DF,Bordeaux,18,2003,1.0,5,2,4,1,0,3,3,100.0,0,1,0,1,0,5,1,0
436,Kévin N'Doram,FRA,MF,Metz,25,1996,13.7,10,8,3,5,2,3,20,15.0,17,24,5,19,19,29,21,0
437,Eric N'Jo,FRA,DF,Troyes,17,2004,1.1,0,0,0,0,0,0,1,0.0,1,1,1,0,2,2,1,0
438,Vital N'Simba,COD,DF,Clermont Foot,28,1993,31.0,66,45,38,23,5,36,63,57.1,27,28,7,21,29,95,30,0
439,Mickael Nade,FRA,DF,Saint-Étienne,22,1999,28.5,57,35,37,18,2,23,38,60.5,15,29,15,14,60,117,84,0
440,Paul Nardi,FRA,GK,Lorient,27,1994,22.0,1,0,1,0,0,1,2,50.0,1,0,0,0,0,1,10,2
441,Keylor Navas,CRC,GK,Paris S-G,34,1986,20.6,0,0,0,0,0,0,0,,0,0,0,0,0,0,5,1
442,Papa Ndiaga Yade,SEN,DF|FW,Metz,21,2000,7.7,15,10,8,7,0,8,18,44.4,10,4,1,3,10,25,9,0
443,Tanguy Ndombele,FRA,MF,Lyon,24,1996,7.8,25,14,5,17,3,12,19,63.2,7,8,3,5,3,28,6,2
444,Dan Ndoye,SUI,FW|MF,Nice,20,2000,2.3,0,0,0,0,0,0,2,0.0,2,4,0,4,0,0,0,0
445,Neymar,BRA,FW|MF,Paris S-G,29,1992,20.6,29,19,5,12,12,12,36,33.3,24,9,1,8,4,33,2,1
446,Yvan Neyou,CMR,MF,Saint-Étienne,24,1997,10.4,29,13,14,12,3,9,27,33.3,18,8,3,5,23,52,13,0
447,Opa Nguette,SEN,FW|MF,Metz,27,1994,11.6,21,14,9,6,6,5,14,35.7,9,13,3,10,2,23,9,0
448,Sikou Niakaté,MLI,DF,Metz,22,1999,7.3,8,7,8,0,0,4,11,36.4,7,5,3,2,27,35,34,0
449,Ibrahima Niane,SEN,FW,Metz,22,1999,17.6,1,1,0,1,0,0,5,0.0,5,6,1,5,3,4,16,0
450,M'Baye Niang,SEN,FW,Bordeaux,26,1994,8.6,4,0,0,2,2,0,4,0.0,4,9,1,8,1,5,4,0
451,Cheikh Niasse,SEN,FW|MF,Lille,21,2000,0.5,2,2,0,2,0,2,3,66.7,1,1,1,0,1,3,2,0
452,Casimir Ninga,CHA,FW,Angers,28,1993,4.5,5,1,1,4,0,2,5,40.0,3,2,0,2,1,6,0,0
453,Arnaud Nordin,FRA,FW|MF,Saint-Étienne,23,1998,20.8,21,11,8,8,5,8,22,36.4,14,19,0,19,6,27,8,0
454,Alexander Nübel,GER,GK,Monaco,24,1996,38.0,0,0,0,0,0,0,1,0.0,1,0,0,0,0,0,11,1
455,Gerzino Nyamsi,FRA,DF,Strasbourg,24,1997,33.2,35,21,24,9,2,20,27,74.1,7,25,16,9,25,60,90,1
456,Florent Ogier,FRA,DF,Clermont Foot,32,1989,27.0,31,17,18,12,1,17,31,54.8,14,41,27,14,37,68,89,0
457,Warmed Omari,FRA,DF,Rennes,21,2000,31.1,33,17,22,10,1,15,23,65.2,8,20,13,7,31,64,94,5
458,Jonas Omlin,SUI,GK,Montpellier,27,1994,28.7,2,1,2,0,0,2,3,66.7,1,0,0,0,0,2,12,3
459,Amadou Onana,BEL,MF,Lille,19,2001,15.1,48,31,17,27,4,18,25,72.0,7,10,3,7,30,78,19,0
460,Jean Onana,CMR,MF,Bordeaux,21,2000,20.4,70,49,33,33,4,35,86,40.7,51,37,5,32,36,106,23,1
461,Otávio,BRA,MF,Bordeaux,27,1994,12.7,36,23,13,21,2,16,39,41.0,23,9,3,6,18,54,11,0
462,Dango Ouattara,BFA,MF|FW,Lorient,19,2002,9.0,21,15,9,11,1,11,23,47.8,12,10,1,9,14,35,15,1
463,Remi Oudin,FRA,MF|FW,Bordeaux,24,1996,19.3,34,18,19,13,2,18,32,56.3,14,14,3,11,27,61,21,0
464,Alexandre Oukidja,ALG,GK,Metz,33,1988,20.8,0,0,0,0,0,0,1,0.0,1,1,0,1,1,1,17,2
465,Azzedine Ounahi,MAR,MF,Angers,21,2000,18.1,39,22,16,22,1,11,40,27.5,29,19,1,18,26,65,13,0
466,Ambroise Oyongo,CMR,DF,Montpellier,30,1991,7.3,13,4,7,4,2,9,15,60.0,6,5,1,4,6,19,17,0
467,Vincent Pajot,FRA,MF,Metz,30,1990,25.7,86,56,35,47,4,20,46,43.5,26,33,6,27,51,137,38,0
468,Nicolas Pallois,FRA,DF,Nantes,33,1987,27.2,51,33,40,11,0,34,59,57.6,25,40,19,21,53,104,116,1
469,Erik Palmer-Brown,USA,DF,Troyes,24,1997,19.3,37,22,29,8,0,20,26,76.9,6,26,18,8,34,71,87,1
470,Emerson Palmieri,ITA,DF,Lyon,26,1994,25.2,46,25,16,22,8,22,34,64.7,12,23,8,15,27,73,66,0
471,Lucas Paquetá,BRA,MF|FW,Lyon,23,1997,30.0,68,38,24,26,18,17,51,33.3,34,43,5,38,9,77,22,0
472,Rubén Pardo,ESP,MF,Bordeaux,28,1992,0.1,0,0,0,0,0,0,0,,0,0,0,0,0,0,0,0
473,Leandro Paredes,ARG,MF,Paris S-G,27,1994,9.3,23,13,9,11,3,12,24,50.0,12,10,6,4,10,33,5,2
474,Strahinja Pavlović,SRB,DF,Monaco,20,2001,5.0,23,16,8,13,2,8,12,66.7,4,5,3,2,9,32,15,0
475,Dimitri Payet,FRA,FW|MF,Marseille,34,1987,28.8,16,8,4,10,2,7,31,22.6,24,9,0,9,9,25,3,0
476,Timothee Pembele,FRA,DF,Bordeaux,18,2002,15.7,20,8,8,10,2,10,29,34.5,19,12,3,9,16,36,24,0
477,Brayann Pereira,FRA,DF|MF,Lens,18,2003,0.2,1,1,1,0,0,1,1,100.0,0,0,0,0,0,1,1,0
478,Danilo Pereira,POR,MF,Paris S-G,29,1991,22.6,33,17,10,20,3,14,28,50.0,14,19,10,9,37,70,29,1
479,Mathias Pereira Lage,POR,DF,Angers,24,1996,11.6,21,7,10,7,4,8,30,26.7,22,18,7,11,21,42,22,0
480,Luan Peres Petroni,BRA,DF,Marseille,27,1994,29.8,65,35,33,25,7,36,52,69.2,16,26,12,14,43,108,64,1
481,Lucas Perrin,FRA,DF,Strasbourg,22,1998,27.8,43,32,24,17,2,26,45,57.8,19,28,11,17,42,85,67,0
482,Danijel Petković,MNE,GK,Angers,28,1993,15.0,0,0,0,0,0,0,1,0.0,1,0,0,0,1,1,9,5
483,Léo Pétrot,FRA,DF,Lorient,24,1997,20.2,31,17,23,8,0,21,29,72.4,8,33,17,16,22,53,86,0
484,Romain Philippoteaux,FRA,MF,Brest,33,1988,0.3,1,1,0,1,0,0,0,,0,0,0,0,0,1,0,0
485,Jérôme Phojo,FRA,DF,Clermont Foot,28,1993,0.1,0,0,0,0,0,0,0,,0,0,0,0,0,0,1,0
486,Jérémy Pied,FRA,DF|FW,Lille,32,1989,0.1,0,0,0,0,0,0,0,,0,0,0,0,1,1,0,0
487,Ronaël Pierre-Gabriel,FRA,DF,Brest,23,1998,28.3,79,45,52,21,6,42,73,57.5,31,22,7,15,48,127,74,0
488,Julian Pollersbeck,GER,GK,Lyon,26,1994,4.8,0,0,0,0,0,0,0,,0,0,0,0,1,1,1,0
489,Gaëtan Poussin,FRA,GK,Bordeaux,22,1999,13.0,1,1,1,0,0,1,1,100.0,0,0,0,0,0,1,15,1
490,Sanjin Prcić,BIH,MF,Strasbourg,27,1993,24.3,47,28,14,27,6,14,29,48.3,15,18,3,15,47,94,19,0
491,Nicolas de Préville,FRA,FW|MF,Metz,30,1991,21.9,17,8,7,8,2,3,19,15.8,16,12,4,8,5,22,11,0
492,Nemanja Radonjić,SRB,FW,Marseille,25,1996,0.2,0,0,0,0,0,0,0,,0,0,0,0,0,0,0,0
493,Rafinha,BRA,FW|MF,Paris S-G,28,1993,2.4,14,8,3,9,2,7,11,63.6,4,3,0,3,4,18,0,0
494,Predrag Rajković,SRB,GK,Reims,25,1995,38.0,2,2,2,0,0,2,3,66.7,1,1,0,1,1,3,21,1
495,Adil Rami,FRA,DF,Troyes,35,1985,13.0,10,9,6,4,0,7,8,87.5,1,17,9,8,16,26,43,0
496,Sergio Ramos,ESP,DF,Paris S-G,35,1986,8.9,12,5,6,6,0,8,15,53.3,7,4,2,2,8,20,27,0
497,Elba Rashani,KVX,FW|MF,Clermont Foot,28,1993,19.5,40,21,15,21,4,17,55,30.9,38,34,3,31,11,51,20,0
498,Jeff Reine-Adélaïde,FRA,MF|DF,Lyon,23,1998,2.2,5,3,4,1,0,4,5,80.0,1,2,0,2,0,5,0,1
499,Tiago Ribeiro,POR,FW,Monaco,19,2002,0.0,0,0,0,0,0,0,0,,0,0,0,0,0,0,0,0
500,Sergio Rico,ESP,GK,Paris S-G,27,1993,0.3,0,0,0,0,0,0,0,,0,0,0,0,0,0,1,0
501,Renaud Ripart,FRA,MF|FW,Troyes,28,1993,21.0,38,21,18,15,5,18,50,36.0,32,21,1,20,19,57,21,1
502,Mihailo Ristić,SRB,DF,Montpellier,25,1995,20.0,44,32,26,16,2,25,43,58.1,18,16,6,10,17,61,48,0
503,Maxence Rivera,FRA,FW,Saint-Étienne,19,2002,0.1,0,0,0,0,0,0,0,,0,0,0,0,0,0,0,0
504,Patrick Roberts,ENG,MF,Troyes,24,1997,0.2,0,0,0,0,0,0,0,,0,0,0,0,0,0,0,0
505,Stian Rode Gregersen,NOR,DF,Bordeaux,26,1995,21.7,39,26,23,12,4,18,33,54.5,15,26,16,10,38,77,103,2
506,Gerson Rodrigues,LUX,FW|MF,Troyes,26,1995,9.4,12,9,2,6,4,1,17,5.9,16,8,1,7,0,12,2,0
507,Valentin Rongier,FRA,MF|DF,Marseille,26,1994,24.4,77,51,36,36,5,28,60,46.7,32,26,5,21,33,110,14,0
508,Pablo Rosario,NED,MF,Nice,24,1997,30.3,59,37,18,32,9,26,66,39.4,40,33,7,26,38,97,43,0
509,Roli Pereira de Sa,FRA,MF,Nantes,24,1996,6.4,12,4,3,5,4,3,20,15.0,17,6,0,6,6,18,3,0
510,Mathys Saban,FRA,FW|MF,Saint-Étienne,19,2002,0.8,4,2,2,2,0,1,1,100.0,0,1,0,1,0,4,0,0
511,Falaye Sacko,MLI,DF,Saint-Étienne,26,1995,7.4,15,10,14,1,0,13,16,81.3,3,11,7,4,4,19,18,2
512,Rafiki Said,COM,MF|FW,Brest,21,2000,1.4,4,3,1,2,1,3,4,75.0,1,2,0,2,0,4,0,0
513,Wesley Saïd,FRA,FW|MF,Lens,26,1995,7.3,10,5,1,8,1,1,9,11.1,8,4,0,4,2,12,0,0
514,Mamadou Sakho,FRA,DF,Montpellier,31,1990,28.6,34,22,26,8,0,16,26,61.5,10,41,34,7,41,75,134,4
515,Bakary Sako,MLI,FW|MF,Saint-Étienne,33,1988,1.7,0,0,0,0,0,0,1,0.0,1,3,1,2,0,0,0,0
516,William Saliba,FRA,DF,Marseille,20,2001,36.0,54,32,36,16,2,27,35,77.1,8,24,16,8,48,102,85,0
517,Romain Salin,FRA,GK,Rennes,37,1984,1.0,0,0,0,0,0,0,0,,0,0,0,0,0,0,0,0
518,Yoann Salmier,GUF,DF,Troyes,28,1992,29.6,58,33,44,11,3,26,34,76.5,8,30,14,16,40,98,94,0
519,Mama Samba Baldé,GNB,MF|FW,Troyes,25,1995,19.1,40,28,16,14,10,8,26,30.8,18,32,1,31,5,45,9,0
520,Junior Sambia,FRA,DF|FW,Montpellier,24,1996,17.0,22,13,12,7,3,13,22,59.1,9,22,3,19,21,43,31,0
521,Renato Sanches,POR,MF|FW,Lille,23,1997,18.3,19,7,8,10,1,9,26,34.6,17,14,3,11,14,33,7,0
522,Philippe Sandler,NED,DF,Troyes,24,1997,0.8,0,0,0,0,0,0,0,,0,1,1,0,3,3,6,0
523,Baptiste Santamaria,FRA,MF|DF,Rennes,26,1995,28.0,52,27,15,31,6,24,44,54.5,20,33,12,21,33,85,42,0
524,Pablo Sarabia,ESP,FW,Paris S-G,29,1992,0.2,0,0,0,0,0,0,1,0.0,1,0,0,0,0,0,0,0
525,Martin Satriano,URU,FW,Brest,20,2001,10.4,5,2,1,1,3,2,7,28.6,5,8,0,8,2,7,3,0
526,Téji Savanier,FRA,MF,Montpellier,29,1991,26.8,46,27,18,19,9,21,59,35.6,38,23,1,22,25,71,12,1
527,Morgan Schneiderlin,FRA,MF,Nice,31,1989,7.2,21,12,9,11,1,6,13,46.2,7,8,2,6,20,41,18,0
528,Alidu Seidu,GHA,DF,Clermont Foot,21,2000,15.7,34,20,20,13,1,16,27,59.3,11,25,11,14,34,68,49,1
529,Matz Sels,BEL,GK,Strasbourg,29,1992,37.0,1,1,1,0,0,0,0,,0,0,0,0,1,2,22,0
530,Xherdan Shaqiri,SUI,FW|MF,Lyon,29,1991,7.5,7,3,0,5,2,2,10,20.0,8,2,0,2,2,9,2,0
531,Mahame Siby,MLI,DF,Strasbourg,25,1996,0.2,0,0,0,0,0,0,0,,0,0,0,0,1,1,2,0
532,Aboubakar Sidibé,FRA,DF,Clermont Foot,25,1996,0.1,0,0,0,0,0,0,0,,0,0,0,0,0,0,0,0
533,Djibril Sidibé,FRA,DF,Monaco,29,1992,10.5,24,13,13,8,3,9,24,37.5,15,10,1,9,16,40,13,0
534,Kaj Sierhuis,NED,FW,Reims,23,1998,0.9,1,1,1,0,0,1,3,33.3,2,0,0,0,0,1,1,0
535,Caio Henrique Oliveira Silva,BRA,DF,Monaco,24,1997,29.6,53,30,31,18,4,28,59,47.5,31,30,6,24,27,80,37,3
536,Gabriel Silva,BRA,DF|MF,Saint-Étienne,30,1991,7.9,12,7,7,2,3,9,13,69.2,4,9,3,6,18,30,13,0
537,Moses Simon,NGA,FW|MF,Nantes,26,1995,25.9,17,11,6,5,6,11,23,47.8,12,14,3,11,12,29,5,0
538,Xavi Simons,NED,MF|FW,Paris S-G,18,2003,1.5,1,1,0,1,0,1,2,50.0,1,3,0,3,0,1,0,0
539,Issouf Sissokho,MLI,MF,Bordeaux,19,2002,4.8,17,8,2,13,2,8,17,47.1,9,8,1,7,7,24,0,0
540,Ibrahima Sissoko,MLI,MF|DF,Strasbourg,23,1997,25.6,47,23,18,20,9,19,46,41.3,27,32,11,21,35,82,31,0
541,Nelson Sissoko,FRA,DF,Saint-Étienne,24,1997,0.5,2,0,2,0,0,1,1,100.0,0,0,0,0,0,2,2,0
542,Sambou Sissoko,FRA,MF|DF,Reims,22,1999,2.0,12,6,6,4,2,6,8,75.0,2,2,0,2,2,14,7,0
543,Islam Slimani,ALG,FW,Lyon,33,1988,6.4,3,2,0,1,2,1,6,16.7,5,4,0,4,2,5,5,0
544,Florian Sotoca,FRA,FW|MF,Lens,30,1990,27.6,31,19,7,20,4,12,51,23.5,39,31,4,27,25,56,41,0
545,Sambou Soumano,SEN,FW|MF,Lorient,20,2001,5.0,4,1,1,2,1,2,2,100.0,0,3,0,3,1,5,7,0
546,Arnaud Souquet,FRA,DF,Montpellier,29,1992,25.9,56,35,30,17,9,32,65,49.2,33,21,7,14,34,90,60,1
547,Saidou Sow,GUI,DF,Saint-Étienne,19,2002,11.0,28,17,21,6,1,16,21,76.2,5,15,5,10,23,51,34,0
548,Calvin Stengs,NED,MF,Nice,22,1998,11.9,16,7,6,9,1,7,20,35.0,13,10,0,10,8,24,6,0
549,Kamaldeen Sulemana,GHA,MF|FW,Rennes,19,2002,11.3,23,12,7,9,7,10,17,58.8,7,10,1,9,4,27,5,0
550,Abdoulaye Sylla,GUI,DF,Nantes,21,2000,1.7,4,4,2,1,1,2,4,50.0,2,5,3,2,1,5,3,0
551,Waniss Taibi,FRA,MF|FW,Angers,19,2002,1.5,8,7,4,4,0,2,4,50.0,2,0,0,0,1,9,1,0
552,Flavien Tait,FRA,MF,Rennes,28,1993,23.6,28,19,13,9,6,13,40,32.5,27,15,4,11,19,47,13,1
553,Florian Tardieu,FRA,MF,Troyes,29,1992,29.2,58,25,31,21,6,31,71,43.7,40,31,9,22,42,100,38,0
554,Oussama Targhalline,MAR,FW,Marseille,19,2002,0.1,0,0,0,0,0,0,0,,0,0,0,0,0,0,0,0
555,Loum Tchaouna,FRA,FW|MF,Rennes,17,2003,1.0,3,1,1,2,0,1,5,20.0,4,0,0,0,2,5,0,0
556,Warren Tchimbembé,CGO,MF,Metz,23,1998,2.3,1,1,0,1,0,0,1,0.0,1,2,1,1,2,3,2,0
557,Aurélien Tchouaméni,FRA,MF,Monaco,21,2000,32.5,86,45,33,49,4,29,55,52.7,26,39,7,32,101,187,34,0
558,Mathys Tel,FRA,FW|MF,Rennes,16,2005,0.6,2,1,1,1,0,0,0,,0,0,0,0,1,3,2,0
559,Jordan Tell,GLP,FW,Clermont Foot,24,1997,3.2,5,5,0,3,2,1,4,25.0,3,3,0,3,0,5,1,0
560,Martin Terrier,FRA,FW|MF,Rennes,24,1997,30.9,55,33,22,16,17,25,43,58.1,18,29,3,26,18,73,17,0
561,Tetê,BRA,FW|MF,Lyon,21,2000,6.5,10,5,4,5,1,3,13,23.1,10,4,0,4,3,13,1,0
562,Sada Thioub,SEN,FW,Angers,26,1995,0.0,0,0,0,0,0,0,0,,0,0,0,0,0,0,0,0
563,Sada Thioub,SEN,DF|MF,Saint-Étienne,26,1995,10.6,13,8,5,8,0,6,14,42.9,8,9,0,9,10,23,8,0
564,Romain Thomas,FRA,DF,Angers,33,1988,28.5,49,37,28,21,0,30,57,52.6,27,35,19,16,44,93,126,0
565,Adrien Thomasson,FRA,MF,Strasbourg,27,1993,26.5,64,31,18,27,19,30,93,32.3,63,56,4,52,29,93,16,1
566,Thuler,BRA,DF,Montpellier,22,1999,9.5,21,12,17,4,0,8,15,53.3,7,9,7,2,9,30,30,0
567,Khéphren Thuram,FRA,MF,Nice,20,2001,21.1,33,19,11,18,4,17,35,48.6,18,31,11,20,28,61,19,0
568,Cheikh Tidiane Sabaly,SEN,FW|MF,Metz,22,1999,1.7,6,3,1,4,1,2,2,100.0,0,1,0,1,0,6,1,0
569,Jean-Clair Todibo,FRA,DF,Nice,21,1999,34.6,59,37,43,15,1,39,60,65.0,21,45,21,24,51,110,130,2
570,Karl Toko Ekambi,CMR,FW,Lyon,28,1992,25.5,13,7,4,6,3,4,21,19.0,17,26,0,26,20,33,5,0
571,Yoann Touzghar,TUN,FW,Troyes,34,1986,16.2,5,2,1,3,1,1,3,33.3,2,3,1,2,3,8,8,0
572,Amadou Traore,FRA,FW,Bordeaux,19,2002,0.2,0,0,0,0,0,0,0,,0,0,0,0,0,0,0,0
573,Boubacar Traoré,MLI,MF,Metz,19,2001,19.2,43,26,18,23,2,10,39,25.6,29,29,5,24,25,68,11,1
574,Charles Traore,MLI,DF,Nantes,29,1992,8.0,16,12,10,4,2,2,13,15.4,11,11,4,7,15,31,30,0
575,Hamari Traoré,MLI,DF,Rennes,29,1992,32.1,63,36,25,26,12,41,59,69.5,18,29,8,21,37,100,81,1
576,Ismaël Traoré,CIV,DF,Angers,34,1986,35.7,28,17,16,11,1,13,28,46.4,15,25,17,8,44,72,122,1
577,Miguel Trauco,PER,DF|MF,Saint-Étienne,28,1992,12.4,25,18,16,8,1,12,22,54.5,10,13,4,9,23,48,17,0
578,Adrien Truffert,FRA,DF,Rennes,19,2001,18.2,29,21,17,9,3,11,24,45.8,13,25,5,20,19,48,30,0
579,Matthieu Udol,FRA,DF,Metz,25,1996,11.2,23,14,11,10,2,12,18,66.7,6,20,7,13,31,54,29,1
580,Ike Ugbo,CAN,FW,Troyes,22,1998,9.0,3,1,0,1,2,0,1,0.0,1,4,1,3,2,5,1,0
581,Lesley Ugochukwu,FRA,MF,Rennes,17,2004,4.5,13,9,5,5,3,9,19,47.4,10,7,2,5,4,17,2,0
582,Hwang Ui-jo,KOR,FW,Bordeaux,28,1992,27.9,10,4,4,4,2,4,13,30.8,9,9,1,8,5,15,18,0
583,Cengiz Ünder,TUR,FW|MF,Marseille,24,1997,24.4,18,13,5,6,7,5,18,27.8,13,13,2,11,14,32,9,0
584,Jere Uronen,FIN,DF,Brest,27,1994,9.8,28,15,15,10,3,14,24,58.3,10,12,3,9,16,44,21,0
585,Vanderson,BRA,FW|DF,Monaco,20,2001,12.4,35,19,10,19,6,15,23,65.2,8,17,4,13,13,48,12,0
586,Jonathan Varane,FRA,MF,Lens,19,2001,0.0,0,0,0,0,0,0,0,,0,0,0,0,0,0,0,0
587,Marco Verratti,ITA,MF,Paris S-G,28,1992,21.5,60,40,16,30,14,32,64,50.0,32,36,10,26,18,78,14,2
588,Kevin Volland,GER,MF|FW,Monaco,29,1992,27.1,24,10,2,18,4,6,31,19.4,25,20,0,20,3,27,9,0
589,Elye Wahi,FRA,FW,Montpellier,18,2003,19.8,18,10,9,6,3,6,16,37.5,10,7,0,7,4,22,4,0
590,Timothy Weah,USA,MF|FW,Lille,21,2000,18.0,19,7,8,8,3,10,20,50.0,10,16,1,15,10,29,7,0
591,Georginio Wijnaldum,NED,MF,Paris S-G,30,1990,18.4,15,9,2,12,1,11,19,57.9,8,13,3,10,9,24,7,0
592,Christopher Wooh,CMR,DF,Lens,19,2001,11.7,29,11,20,8,1,11,18,61.1,7,21,14,7,21,50,40,1
593,Xeka,POR,MF,Lille,26,1994,18.0,47,27,18,24,5,27,56,48.2,29,23,3,20,24,71,26,1
594,Sekou Yansané,GUI,FW,Paris S-G,18,2003,0.2,0,0,0,0,0,0,1,0.0,1,0,0,0,0,0,1,0
595,Yusuf Yazıcı,TUR,MF|FW,Lille,24,1997,5.7,10,5,3,6,1,1,9,11.1,8,4,0,4,2,12,1,0
596,Burak Yılmaz,TUR,FW,Lille,36,1985,24.6,7,2,0,2,5,2,17,11.8,15,8,1,7,2,9,11,0
597,Leny Yoro,FRA,MF,Lille,15,2005,0.1,1,0,0,1,0,0,0,,0,1,0,1,0,1,0,0
598,Zaydou Youssouf,FRA,MF,Saint-Étienne,22,1999,17.3,48,26,21,25,2,14,34,41.2,20,11,3,8,17,65,13,0
599,Akim Zedadka,ALG,DF,Clermont Foot,26,1995,37.1,72,44,34,29,9,37,71,52.1,34,32,8,24,58,130,48,0
600,Arber Zeneli,KVX,FW,Reims,26,1995,4.5,1,0,0,0,1,1,5,20.0,4,0,0,0,1,2,1,0
601,Mehdi Zerkane,ALG,MF|DF,Bordeaux,22,1999,0.9,0,0,0,0,0,0,1,0.0,1,1,1,0,2,2,0,0
602,Edon Zhegrova,KVX,MF|FW,Lille,22,1999,5.3,14,5,2,8,4,5,6,83.3,1,4,1,3,2,16,2,0
603,Tanguy Zoukrou,FRA,DF,Troyes,18,2003,0.9,1,0,1,0,0,1,2,50.0,1,0,0,0,0,1,2,0
