Rk,Player,Nation,Pos,Squad,Age,Born,90s,Tackles Tkl,Tackles TklW,Tackles Def 3rd,Tackles Mid 3rd,Tackles Att 3rd,Challenges Tkl,Challenges Att,Challenges Tkl%,Challenges Lost,Blocks Blocks,Blocks Sh,Blocks Pass,Int,Tkl+Int,Clr,Err
1,Max Aarons,ENG,DF,Norwich City,21,2000,32.0,64,44,49,15,0,37,55,67.3,18,39,19,20,28,92,96,1
2,Che Adams,SCO,FW,Southampton,25,1996,22.7,13,6,5,5,3,2,16,12.5,14,18,2,16,8,21,18,0
3,Rayan Aït Nouri,ALG,DF|MF,Wolves,20,2001,20.3,64,36,46,15,3,22,44,50.0,22,24,2,22,22,86,39,1
4,Kristoffer Ajer,NOR,DF,Brentford,23,1998,22.2,29,18,21,6,2,13,21,61.9,8,19,11,8,26,55,74,0
5,Nathan Aké,NED,DF,Manchester City,26,1995,10.3,16,9,7,8,1,6,8,75.0,2,7,5,2,8,24,23,0
6,Marc Albrighton,ENG,FW|DF,Leicester City,31,1989,12.6,31,19,16,9,6,10,47,21.3,37,15,3,12,14,45,20,0
7,Thiago Alcántara,ESP,MF,Liverpool,30,1991,17.0,48,29,14,24,10,10,42,23.8,32,22,2,20,26,74,13,2
8,Trent Alexander-Arnold,ENG,DF,Liverpool,22,1998,31.7,40,23,19,13,8,27,60,45.0,33,22,4,18,43,83,40,0
9,Alisson,BRA,GK,Liverpool,28,1992,36.0,3,1,3,0,0,3,5,60.0,2,1,0,1,0,3,28,1
10,Allan,BRA,MF,Everton,30,1991,24.3,74,44,28,39,7,34,105,32.4,71,40,9,31,23,97,39,1
11,Dele Alli,ENG,MF,Tottenham,25,1996,7.3,14,8,10,3,1,5,17,29.4,12,22,5,17,6,20,16,0
12,Dele Alli,ENG,MF|FW,Everton,25,1996,3.8,7,2,3,4,0,0,4,0.0,4,7,2,5,6,13,10,0
13,Miguel Almirón,PAR,MF|FW,Newcastle Utd,27,1994,19.1,47,29,23,17,7,11,44,25.0,33,14,1,13,20,67,13,0
14,Marcos Alonso,ESP,DF,Chelsea,30,1990,24.1,41,29,20,12,9,17,36,47.2,19,29,5,24,43,84,53,0
15,Steven Alzate,COL,MF,Brighton,22,1998,4.5,10,4,4,5,1,4,7,57.1,3,2,1,1,10,20,10,0
16,Daniel Amartey,GHA,DF,Leicester City,26,1994,23.6,26,13,19,7,0,19,29,65.5,10,30,22,8,21,47,93,4
17,Joachim Andersen,DEN,DF,Crystal Palace,25,1996,32.4,30,23,21,9,0,16,27,59.3,11,29,19,10,37,67,125,3
18,Michail Antonio,JAM,FW,West Ham,31,1990,33.0,23,17,5,9,9,7,18,38.9,11,19,1,18,3,26,13,0
19,Cameron Archer,ENG,FW|MF,Aston Villa,20,2001,0.3,0,0,0,0,0,0,0,,0,0,0,0,0,0,0,0
20,Alphonse Areola,FRA,GK,West Ham,28,1993,1.0,0,0,0,0,0,0,0,,0,0,0,0,0,0,1,0
21,Adam Armstrong,ENG,FW,Southampton,24,1997,15.7,10,4,2,2,6,0,6,0.0,6,13,1,12,3,13,6,0
22,Stuart Armstrong,SCO,MF,Southampton,29,1992,16.4,27,19,15,6,6,9,23,39.1,14,10,1,9,8,35,15,0
23,Kepa Arrizabalaga,ESP,GK,Chelsea,26,1994,4.0,0,0,0,0,0,0,0,,0,0,0,0,0,0,4,0
24,Harrison Ashby,SCO,DF,West Ham,19,2001,0.1,0,0,0,0,0,0,0,,0,1,0,1,1,1,1,0
25,Pierre-Emerick Aubameyang,GAB,FW,Arsenal,32,1989,11.5,11,5,6,4,1,3,10,30.0,7,12,1,11,0,11,4,0
26,Jordan Ayew,GHA,FW,Crystal Palace,29,1991,22.4,47,30,20,20,7,17,31,54.8,14,33,3,30,15,62,15,0
27,Luke Ayling,ENG,DF,Leeds United,29,1991,25.2,74,42,46,23,5,51,97,52.6,46,46,25,21,28,102,52,1
28,César Azpilicueta,ESP,DF,Chelsea,31,1989,23.0,51,28,18,27,6,16,35,45.7,19,32,9,23,23,74,65,1
29,Daniel Bachmann,AUT,GK,Watford,27,1994,12.0,0,0,0,0,0,0,0,,0,0,0,0,1,1,5,0
30,Leon Bailey,JAM,FW|MF,Aston Villa,23,1997,8.5,17,11,6,8,3,6,13,46.2,7,10,1,9,1,18,2,0
31,Eric Bailly,CIV,DF,Manchester Utd,27,1994,2.4,5,4,4,0,1,3,4,75.0,1,4,2,2,3,8,11,0
32,Folarin Balogun,USA,FW,Arsenal,20,2001,0.8,1,1,0,0,1,0,0,,0,1,0,1,0,1,1,0
33,Patrick Bamford,ENG,FW,Leeds United,27,1993,6.2,1,0,0,1,0,0,3,0.0,3,8,2,6,2,3,8,0
34,Shandon Baptiste,GRN,MF,Brentford,23,1998,10.1,14,4,9,4,1,6,15,40.0,9,10,0,10,11,25,12,0
35,Ross Barkley,ENG,MF|FW,Chelsea,27,1993,2.0,0,0,0,0,0,0,1,0.0,1,1,0,1,1,1,0,0
36,Ashley Barnes,ENG,FW,Burnley,31,1989,9.0,11,2,2,7,2,2,9,22.2,7,8,1,7,2,13,5,0
37,Harvey Barnes,ENG,FW|MF,Leicester City,23,1997,23.3,31,16,9,11,11,7,23,30.4,16,24,1,23,5,36,7,0
38,Lewis Bate,ENG,MF,Leeds United,18,2002,1.6,1,0,0,0,1,0,8,0.0,8,1,0,1,1,2,1,0
39,Mads Bech Sørensen,DEN,DF,Brentford,22,1999,9.3,8,7,6,2,0,6,7,85.7,1,9,6,3,6,14,25,0
40,Jan Bednarek,POL,DF,Southampton,25,1996,29.2,32,15,18,13,1,19,33,57.6,14,48,27,21,72,104,141,0
41,Donny van de Beek,NED,MF,Manchester Utd,24,1997,0.8,6,4,4,1,1,1,2,50.0,1,5,1,4,2,8,1,0
42,Donny van de Beek,NED,MF,Everton,24,1997,5.4,15,7,8,6,1,6,13,46.2,7,6,2,4,6,21,4,0
43,Asmir Begović,BIH,GK,Everton,34,1987,3.0,0,0,0,0,0,0,0,,0,0,0,0,0,0,3,0
44,Saïd Benrahma,ALG,FW|MF,West Ham,25,1995,24.1,28,17,16,9,3,15,38,39.5,23,17,1,16,9,37,8,0
45,Rodrigo Bentancur,URU,MF,Tottenham,24,1997,15.1,36,18,14,14,8,16,32,50.0,16,24,9,15,20,56,35,0
46,Christian Benteke,BEL,FW,Crystal Palace,30,1990,12.7,3,2,1,2,0,2,6,33.3,4,7,3,4,2,5,33,0
47,Jóhann Berg Guðmundsson,ISL,MF,Burnley,30,1990,12.2,16,6,7,7,2,5,20,25.0,15,11,2,9,12,28,22,0
48,Steven Bergwijn,NED,FW|MF,Tottenham,23,1997,6.3,3,2,2,1,0,1,10,10.0,9,3,0,3,1,4,8,0
49,Ryan Bertrand,ENG,DF,Leicester City,31,1989,3.7,8,5,3,4,1,2,5,40.0,3,8,3,5,1,9,7,0
50,Mads Bidstrup,DEN,MF,Brentford,20,2001,0.5,1,0,0,1,0,0,3,0.0,3,0,0,0,1,2,2,0
51,Yves Bissouma,MLI,MF,Brighton,24,1996,23.5,76,49,35,37,4,21,37,56.8,16,33,3,30,50,126,49,0
52,Willy Boly,CIV,DF,Wolves,30,1991,10.0,25,19,18,7,0,8,15,53.3,7,14,6,8,14,39,35,0
53,Jarrod Bowen,ENG,FW,West Ham,24,1996,33.1,36,20,20,11,5,17,44,38.6,27,29,2,27,21,57,14,0
54,Jarrad Branthwaite,ENG,DF,Everton,19,2002,4.3,4,1,3,1,0,3,8,37.5,5,3,2,1,1,5,20,0
55,Armando Broja,ALB,FW,Southampton,19,2001,21.9,12,5,2,7,3,2,9,22.2,7,17,1,16,3,15,11,0
56,Josh Brownhill,ENG,MF,Burnley,25,1995,32.8,73,37,25,42,6,21,53,39.6,32,37,12,25,68,141,42,1
57,Lewis Brunt,ENG,MF,Leicester City,20,2000,0.3,0,0,0,0,0,0,0,,0,1,0,1,0,0,0,0
58,Emi Buendía,ARG,MF|FW,Aston Villa,24,1996,21.1,38,18,16,13,9,21,51,41.2,30,21,3,18,9,47,11,0
59,Dan Burn,ENG,DF,Newcastle Utd,29,1992,16.0,16,11,11,4,1,7,11,63.6,4,22,14,8,20,36,101,0
60,Dan Burn,ENG,DF,Brighton,29,1992,11.4,22,12,13,8,1,6,15,40.0,9,14,10,4,24,46,51,0
61,Jack Butland,ENG,GK,Crystal Palace,28,1993,8.5,0,0,0,0,0,0,0,,0,0,0,0,0,0,1,0
62,Sam Byram,ENG,DF,Norwich City,27,1993,11.4,24,15,17,6,1,19,27,70.4,8,21,11,10,22,46,48,0
63,Willy Caballero,ARG,GK,Southampton,39,1981,2.0,0,0,0,0,0,0,0,,0,0,0,0,0,0,2,1
64,Moisés Caicedo,ECU,MF,Brighton,19,2001,7.3,16,10,7,7,2,5,12,41.7,7,18,4,14,10,26,7,0
65,Dominic Calvert-Lewin,ENG,FW,Everton,24,1997,14.3,11,8,1,6,4,3,8,37.5,5,5,2,3,3,14,12,0
66,Chem Campbell,WAL,MF,Wolves,18,2002,0.1,1,1,0,1,0,0,0,,0,0,0,0,0,1,0,0
67,João Cancelo,POR,DF,Manchester City,27,1994,35.9,83,54,33,35,15,46,91,50.5,45,25,3,22,59,142,45,1
68,Sergi Canós,ESP,DF|FW,Brentford,24,1997,23.1,56,25,32,15,9,33,60,55.0,27,32,3,29,22,78,38,0
69,Todd Cantwell,ENG,FW|MF,Norwich City,23,1998,4.9,15,13,8,6,1,6,17,35.3,11,2,0,2,3,18,2,0
70,Matty Cash,POL,DF,Aston Villa,23,1997,37.5,89,50,52,34,3,47,78,60.3,31,54,16,38,49,138,100,2
71,Timothy Castagne,BEL,DF,Leicester City,25,1995,23.6,67,31,38,22,7,27,43,62.8,16,28,9,19,29,96,54,1
72,Jonny Castro,ESP,DF,Wolves,27,1994,11.4,25,15,13,11,1,11,20,55.0,9,14,3,11,13,38,11,0
73,Craig Cathcart,NIR,DF,Watford,32,1989,26.6,32,15,25,6,1,16,30,53.3,14,39,29,10,28,60,132,3
74,Edinson Cavani,URU,FW,Manchester Utd,34,1987,8.5,4,1,0,3,1,2,8,25.0,6,6,0,6,2,6,8,0
75,Kayky Chagas,BRA,FW,Manchester City,18,2003,0.1,0,0,0,0,0,0,0,,0,0,0,0,0,0,0,0
76,Trevoh Chalobah,ENG,DF,Chelsea,22,1999,16.1,40,27,22,18,0,24,31,77.4,7,16,6,10,19,59,43,2
77,Calum Chambers,ENG,DF,Arsenal,26,1995,1.9,5,3,3,1,1,3,4,75.0,1,6,3,3,0,5,10,0
78,Calum Chambers,ENG,DF,Aston Villa,26,1995,9.2,16,8,10,6,0,4,6,66.7,2,14,8,6,5,21,42,0
79,Daniel Chesters,ENG,MF,West Ham,19,2002,0.0,0,0,0,0,0,0,0,,0,0,0,0,0,0,0,0
80,Ben Chilwell,ENG,DF,Chelsea,24,1996,6.0,8,3,2,6,0,2,5,40.0,3,7,0,7,4,12,14,1
81,Chiquinho,POR,DF|FW,Wolves,21,2000,2.3,9,6,4,5,0,4,5,80.0,1,5,0,5,2,11,1,0
82,Hamza Choudhury,ENG,DF|MF,Leicester City,23,1997,3.2,9,3,4,4,1,3,5,60.0,2,0,0,0,12,21,10,0
83,Andreas Christensen,DEN,DF,Chelsea,25,1996,16.6,14,8,9,4,1,4,7,57.1,3,14,6,8,29,43,57,1
84,Carney Chukwuemeka,ENG,MF|FW,Aston Villa,17,2003,3.3,7,1,2,5,0,3,5,60.0,2,3,0,3,1,8,2,1
85,Ciaran Clark,IRL,DF,Newcastle Utd,31,1989,11.3,13,10,4,7,2,9,14,64.3,5,14,11,3,13,26,43,1
86,Tom Cleverley,ENG,MF,Watford,31,1989,18.0,37,20,19,17,1,18,33,54.5,15,23,6,17,18,55,19,3
87,Nathaniel Clyne,ENG,DF,Crystal Palace,30,1991,15.0,21,10,11,9,1,10,20,50.0,10,7,2,5,15,36,32,0
88,Conor Coady,ENG,DF,Wolves,28,1993,37.3,31,14,23,7,1,16,28,57.1,12,46,40,6,28,59,140,0
89,Séamus Coleman,IRL,DF,Everton,32,1988,29.5,61,36,35,16,10,33,51,64.7,18,30,11,19,32,93,80,2
90,Nathan Collins,IRL,DF,Burnley,20,2001,18.6,37,15,27,8,2,17,27,63.0,10,38,25,13,24,61,83,2
91,Aaron Connolly,IRL,FW|MF,Brighton,21,2000,1.7,0,0,0,0,0,0,1,0.0,1,2,0,2,0,0,0,0
92,Liam Cooper,SCO,DF,Leeds United,29,1991,20.2,41,23,27,13,1,23,33,69.7,10,29,18,11,43,84,72,2
93,Jack Cork,ENG,MF,Burnley,32,1989,18.6,20,6,6,11,3,7,20,35.0,13,17,4,13,17,37,29,1
94,Maxwel Cornet,CIV,FW|MF,Burnley,24,1996,19.6,16,9,7,5,4,7,15,46.7,8,13,4,9,10,26,14,0
95,Hélder Costa,ANG,MF,Leeds United,27,1994,0.2,0,0,0,0,0,0,0,,0,1,0,1,0,0,0,0
96,Vladimír Coufal,CZE,DF,West Ham,28,1992,24.5,45,25,24,14,7,18,36,50.0,18,31,9,22,22,67,64,1
97,Philippe Coutinho,BRA,MF|FW,Aston Villa,29,1992,14.8,17,12,4,11,2,6,21,28.6,15,11,1,10,7,24,4,0
98,Aaron Cresswell,ENG,DF,West Ham,31,1989,30.3,28,18,18,6,4,13,25,52.0,12,31,18,13,35,63,66,0
99,Charlie Cresswell,ENG,DF,Leeds United,18,2002,1.6,5,2,1,4,0,3,3,100.0,0,1,1,0,2,7,6,0
100,Cucho,COL,FW|MF,Watford,22,1999,12.7,13,5,5,5,3,5,27,18.5,22,13,1,12,5,18,9,0
101,Marc Cucurella,ESP,DF,Brighton,23,1998,34.3,93,62,43,32,18,44,71,62.0,27,42,14,28,30,123,74,0
102,Luke Cundle,ENG,MF,Wolves,19,2002,2.0,4,3,0,4,0,1,1,100.0,0,0,0,0,1,5,1,0
103,Patson Daka,ZAM,FW,Leicester City,22,1998,12.9,15,10,2,8,5,2,19,10.5,17,7,0,7,2,17,8,0
104,Stuart Dallas,NIR,DF|MF,Leeds United,30,1991,32.4,93,55,58,31,4,56,105,53.3,49,45,14,31,57,150,63,2
105,Diogo Dalot,POR,DF,Manchester Utd,22,1999,20.0,55,41,35,12,8,31,57,54.4,26,24,13,11,29,84,59,0
106,Karl Darlow,ENG,GK,Newcastle Utd,30,1990,8.0,0,0,0,0,0,0,0,,0,0,0,0,0,0,5,1
107,Josh Dasilva,ENG,MF|FW,Brentford,22,1998,2.9,2,1,0,1,1,1,2,50.0,1,3,0,3,1,3,7,0
108,Ben Davies,WAL,DF,Tottenham,28,1993,28.2,36,21,20,12,4,13,26,50.0,13,32,19,13,30,66,75,1
109,Tom Davies,ENG,MF,Everton,23,1998,2.6,3,1,1,1,1,2,5,40.0,3,2,1,1,2,5,9,0
110,Keinan Davis,ENG,FW,Aston Villa,23,1998,0.1,0,0,0,0,0,0,0,,0,0,0,0,0,0,0,0
111,Craig Dawson,ENG,DF,West Ham,31,1990,30.6,29,17,20,8,1,14,25,56.0,11,59,52,7,29,58,139,0
112,Kevin De Bruyne,BEL,MF,Manchester City,30,1991,24.5,32,16,4,15,13,12,37,32.4,25,32,2,30,6,38,16,0
113,Troy Deeney,ENG,FW,Watford,33,1988,0.3,0,0,0,0,0,0,1,0.0,1,0,0,0,0,0,2,0
114,Liam Delap,ENG,FW,Manchester City,18,2003,0.1,0,0,0,0,0,0,0,,0,0,0,0,0,0,0,0
115,Fabian Delph,ENG,MF,Everton,31,1989,7.4,18,15,10,7,1,8,21,38.1,13,12,5,7,14,32,10,0
116,Leander Dendoncker,BEL,MF,Wolves,26,1995,21.7,42,17,25,14,3,22,50,44.0,28,37,10,27,9,51,38,1
117,Emmanuel Dennis,NGA,FW|MF,Watford,23,1997,28.7,51,35,20,22,9,17,52,32.7,35,36,2,34,15,66,13,0
118,Kiernan Dewsbury-Hall,ENG,MF,Leicester City,22,1998,23.4,39,24,20,14,5,19,40,47.5,21,37,8,29,21,60,26,1
119,Ibrahima Diallo,FRA,MF,Southampton,22,1999,11.4,22,11,10,9,3,10,24,41.7,14,7,0,7,9,31,10,0
120,Rúben Dias,POR,DF,Manchester City,24,1997,26.7,26,19,11,12,3,8,15,53.3,7,19,13,6,23,49,66,0
121,Luis Díaz,COL,FW,Liverpool,24,1997,10.6,9,7,3,5,1,2,8,25.0,6,7,0,7,4,13,2,0
122,Eric Dier,ENG,DF,Tottenham,27,1994,34.1,15,9,6,8,1,7,14,50.0,7,37,32,5,27,42,142,1
123,Lucas Digne,FRA,DF,Aston Villa,28,1993,14.1,13,10,8,3,2,9,19,47.4,10,15,8,7,23,36,40,0
124,Lucas Digne,FRA,DF,Everton,28,1993,13.0,33,19,26,4,3,21,28,75.0,7,16,5,11,14,47,30,0
125,Issa Diop,FRA,DF,West Ham,24,1997,10.7,10,8,5,5,0,4,11,36.4,7,14,13,1,7,17,44,0
126,Moussa Djenepo,MLI,MF,Southampton,23,1998,5.1,9,3,3,5,1,3,11,27.3,8,6,1,5,2,11,6,1
127,Lewis Dobbin,ENG,FW|MF,Everton,18,2003,0.4,2,1,0,1,1,1,2,50.0,1,0,0,0,0,2,0,0
128,Matt Doherty,IRL,DF,Tottenham,29,1992,9.7,18,12,5,11,2,8,14,57.1,6,11,2,9,13,31,20,0
129,Gabriel Dos Santos,BRA,DF,Arsenal,23,1997,34.0,50,30,36,12,2,30,41,73.2,11,34,26,8,13,63,112,4
130,Abdoulaye Doucouré,MLI,MF,Everton,28,1993,28.2,75,43,30,37,8,32,71,45.1,39,33,8,25,28,103,32,0
131,Kieran Dowell,ENG,FW|MF,Norwich City,23,1997,10.1,18,7,8,7,3,9,32,28.1,23,10,1,9,7,25,4,0
132,Cody Drameh,ENG,DF|MF,Leeds United,19,2001,1.4,4,2,3,1,0,1,3,33.3,2,0,0,0,1,5,4,0
133,Martin Dúbravka,SVK,GK,Newcastle Utd,32,1989,26.0,1,1,1,0,0,0,1,0.0,1,0,0,0,0,1,8,2
134,Shane Duffy,IRL,DF,Brighton,29,1992,16.0,15,12,12,3,0,8,14,57.1,6,24,18,6,16,31,76,1
135,Paul Dummett,WAL,DF,Newcastle Utd,29,1991,2.2,7,3,3,4,0,5,8,62.5,3,5,0,5,3,10,5,0
136,Lewis Dunk,ENG,DF,Brighton,29,1991,28.6,10,8,5,5,0,5,11,45.5,6,32,28,4,27,37,113,3
137,Ederson,BRA,GK,Manchester City,27,1993,37.0,2,1,2,0,0,0,2,0.0,2,0,0,0,0,2,12,0
138,Odsonne Édouard,FRA,FW,Crystal Palace,23,1998,17.4,16,10,2,7,7,7,21,33.3,14,20,5,15,0,16,18,0
139,CJ Egan-Riley,ENG,DF,Manchester City,18,2003,0.0,1,1,1,0,0,1,1,100.0,0,0,0,0,0,1,0,0
140,Anthony Elanga,SWE,FW,Manchester Utd,19,2002,13.5,26,20,12,12,2,15,29,51.7,14,17,1,16,9,35,7,0
141,Harvey Elliott,ENG,MF,Liverpool,18,2003,3.8,3,0,1,1,1,0,6,0.0,6,8,1,7,4,7,2,0
142,Mohamed Elneny,EGY,MF,Arsenal,29,1992,9.0,16,8,10,5,1,7,12,58.3,5,7,1,6,14,30,13,0
143,Mohamed Elyounoussi,NOR,MF|FW,Southampton,26,1994,22.7,36,17,14,15,7,11,39,28.2,28,23,2,21,12,48,28,0
144,Emerson,BRA,DF|MF,Tottenham,22,1999,25.4,72,47,50,16,6,36,67,53.7,31,25,2,23,22,94,92,1
145,Christian Eriksen,DEN,MF,Brentford,29,1992,10.4,13,6,4,5,4,8,17,47.1,9,9,1,8,9,22,14,0
146,Oghenekaro Etebo,NGA,MF,Watford,25,1995,4.5,11,8,7,4,0,3,8,37.5,5,3,1,2,5,16,5,0
147,Jonny Evans,NIR,DF,Leicester City,33,1988,15.0,24,14,14,8,2,14,22,63.6,8,17,13,4,20,44,59,0
148,Eberechi Eze,ENG,MF|FW,Crystal Palace,23,1998,6.7,10,6,5,2,3,6,11,54.5,5,4,1,3,5,15,1,0
149,Łukasz Fabiański,POL,GK,West Ham,36,1985,37.0,0,0,0,0,0,0,0,,0,0,0,0,0,0,11,0
150,Fabinho,BRA,MF,Liverpool,27,1993,25.7,46,25,17,23,6,24,70,34.3,46,33,10,23,39,85,25,1
151,Kiko Femenía,ESP,DF,Watford,30,1991,23.8,35,22,23,10,2,21,37,56.8,16,24,8,16,37,72,51,0
152,Evan Ferguson,IRL,MF,Brighton,16,2004,0.3,0,0,0,0,0,0,0,,0,0,0,0,0,0,0,0
153,Nathan Ferguson,ENG,DF,Crystal Palace,20,2000,0.1,0,0,0,0,0,0,0,,0,0,0,0,0,0,0,0
154,Bruno Fernandes,POR,MF,Manchester Utd,26,1994,34.6,54,28,26,22,6,26,91,28.6,65,36,0,36,17,71,42,2
155,Álvaro Fernández,ESP,GK,Brentford,23,1998,12.0,0,0,0,0,0,0,0,,0,0,0,0,0,0,5,2
156,Federico Fernández,ARG,DF,Newcastle Utd,32,1989,5.8,3,0,3,0,0,2,5,40.0,3,10,10,0,4,7,28,0
157,Fernandinho,BRA,MF|DF,Manchester City,36,1985,10.7,21,10,7,10,4,9,27,33.3,18,8,2,6,8,29,13,1
158,Roberto Firmino,BRA,FW,Liverpool,29,1991,11.0,23,14,5,8,10,3,16,18.8,13,20,0,20,4,27,3,0
159,Junior Firpo,ESP,DF|MF,Leeds United,24,1996,19.0,61,29,30,26,5,31,59,52.5,28,22,6,16,24,85,37,0
160,Ashley Fletcher,ENG,FW,Watford,25,1995,0.3,2,1,1,1,0,1,1,100.0,0,1,1,0,0,2,0,0
161,Phil Foden,ENG,FW,Manchester City,21,2000,23.6,16,8,10,4,2,7,17,41.2,10,9,0,9,11,27,5,0
162,Wesley Fofana,FRA,DF,Leicester City,20,2000,7.0,12,8,11,1,0,7,11,63.6,4,5,2,3,12,24,26,1
163,Pablo Fornals,ESP,FW|MF,West Ham,25,1996,31.1,54,28,21,21,12,22,84,26.2,62,49,2,47,27,81,16,1
164,Adam Forshaw,ENG,MF,Leeds United,29,1991,17.0,53,23,21,27,5,21,54,38.9,33,17,1,16,19,72,12,2
165,Marcus Forss,FIN,FW|MF,Brentford,22,1999,2.3,3,3,0,2,1,2,4,50.0,2,5,0,5,1,4,0,0
166,Fraser Forster,ENG,GK,Southampton,33,1988,19.0,1,0,1,0,0,0,1,0.0,1,0,0,0,0,1,23,2
167,Ben Foster,ENG,GK,Watford,38,1983,26.0,0,0,0,0,0,0,3,0.0,3,0,0,0,0,0,9,4
168,Tariqe Fosu,GHA,DF,Brentford,25,1995,0.2,0,0,0,0,0,0,0,,0,1,0,1,0,0,0,0
169,Ryan Fraser,SCO,FW|MF,Newcastle Utd,27,1994,16.3,10,3,5,3,2,5,13,38.5,8,11,1,10,11,21,11,0
170,Fred,BRA,MF,Manchester Utd,28,1993,22.5,63,27,32,24,7,22,79,27.8,57,38,11,27,32,95,24,0
171,Ryan Fredericks,ENG,DF,West Ham,28,1992,3.4,2,2,2,0,0,0,1,0.0,1,2,1,1,4,6,6,0
172,Leo Fuhr Hjelde,NOR,MF|DF,Leeds United,17,2003,1.7,5,4,3,2,0,3,3,100.0,0,3,3,0,4,9,7,0
173,Conor Gallagher,ENG,MF,Crystal Palace,21,2000,31.6,69,38,35,20,14,21,69,30.4,48,58,9,49,29,98,26,0
174,Alejandro Garnacho,ARG,FW|MF,Manchester Utd,17,2004,0.1,0,0,0,0,0,0,1,0.0,1,0,0,0,0,0,0,0
175,Dwight Gayle,ENG,FW|DF,Newcastle Utd,30,1990,0.4,1,0,0,1,0,0,1,0.0,1,0,0,0,1,2,0,0
176,Jean-Philippe Gbamin,CIV,MF,Everton,25,1995,0.7,1,1,1,0,0,0,2,0.0,2,0,0,0,1,2,1,0
177,David de Gea,ESP,GK,Manchester Utd,30,1990,38.0,0,0,0,0,0,0,0,,0,0,0,0,0,0,11,2
178,Joe Gelhardt,ENG,FW|MF,Leeds United,19,2002,8.3,4,3,1,0,3,2,10,20.0,8,9,0,9,0,4,3,0
179,Anwar El Ghazi,NED,FW|MF,Aston Villa,26,1995,4.3,4,4,2,2,0,2,7,28.6,5,6,0,6,1,5,2,0
180,Anwar El Ghazi,NED,FW|MF,Everton,26,1995,0.1,1,1,1,0,0,1,1,100.0,0,3,0,3,0,1,0,0
181,Saman Ghoddos,IRN,MF|DF,Brentford,27,1993,6.0,17,10,8,6,3,9,15,60.0,6,2,0,2,3,20,16,0
182,Dimitris Giannoulis,GRE,DF,Norwich City,25,1995,13.0,36,21,17,17,2,24,36,66.7,12,22,6,16,19,55,41,1
183,Morgan Gibbs-White,ENG,DF|FW,Wolves,21,2000,0.1,0,0,0,0,0,0,0,,0,1,0,1,0,0,0,0
184,Ben Gibson,ENG,DF,Norwich City,28,1993,27.7,23,16,17,6,0,7,12,58.3,5,36,30,6,27,50,139,2
185,Bryan Gil,ESP,FW|MF,Tottenham,20,2001,1.0,3,0,1,0,2,1,2,50.0,1,2,0,2,0,3,0,0
186,Billy Gilmour,SCO,MF,Norwich City,20,2001,20.6,41,21,16,21,4,14,52,26.9,38,21,4,17,17,58,29,0
187,Ben Godfrey,ENG,DF,Everton,23,1998,22.5,47,32,29,14,4,24,39,61.5,15,41,19,22,15,62,100,2
188,André Gomes,POR,MF,Everton,28,1993,6.9,16,4,6,6,4,8,32,25.0,24,8,2,6,1,17,7,1
189,Toti Gomes,POR,DF,Wolves,22,1999,4.0,11,7,10,1,0,7,9,77.8,2,6,3,3,8,19,15,0
190,Joe Gomez,ENG,DF,Liverpool,24,1997,3.7,10,6,5,2,3,5,9,55.6,4,4,1,3,5,15,6,0
191,Charlie Goode,ENG,DF,Brentford,25,1995,5.0,7,5,5,2,0,4,4,100.0,0,4,2,2,2,9,8,0
192,Anthony Gordon,ENG,MF|FW,Everton,20,2001,25.4,54,32,20,30,4,21,59,35.6,38,49,3,46,22,76,17,0
193,Kaide Gordon,ENG,FW,Liverpool,16,2004,0.1,1,0,0,0,1,0,0,,0,0,0,0,0,1,0,0
194,Dan Gosling,ENG,MF,Watford,31,1990,1.8,2,1,1,1,0,2,6,33.3,4,2,0,2,0,2,3,0
195,Demarai Gray,JAM,MF|FW,Everton,25,1996,26.0,30,19,13,10,7,10,22,45.5,12,30,2,28,15,45,21,1
196,Jack Grealish,ENG,FW,Manchester City,25,1995,21.3,18,17,4,10,4,5,13,38.5,8,11,1,10,8,26,7,0
197,Mason Greenwood,ENG,FW|MF,Manchester Utd,19,2001,14.1,15,9,9,1,5,3,9,33.3,6,5,0,5,1,16,6,0
198,Sam Greenwood,ENG,MF|FW,Leeds United,19,2002,2.6,8,5,0,5,3,4,7,57.1,3,3,0,3,2,10,1,0
199,Pascal Groß,GER,MF|DF,Brighton,30,1991,22.6,28,15,15,11,2,12,33,36.4,21,34,8,26,18,46,23,0
200,Vicente Guaita,ESP,GK,Crystal Palace,34,1987,29.5,1,0,1,0,0,1,1,100.0,0,0,0,0,1,2,8,1
201,Marc Guéhi,ENG,DF,Crystal Palace,21,2000,35.8,35,17,24,10,1,15,16,93.8,1,34,26,8,30,65,127,0
202,Bruno Guimarães,BRA,MF,Newcastle Utd,23,1997,11.5,44,23,18,22,4,21,38,55.3,17,25,6,19,9,53,13,0
203,İlkay Gündoğan,GER,MF,Manchester City,30,1990,20.6,23,9,10,12,1,12,31,38.7,19,11,1,10,15,38,10,0
204,Angus Gunn,SCO,GK,Norwich City,25,1996,9.0,0,0,0,0,0,0,0,,0,0,0,0,0,0,11,0
205,Grant Hanley,SCO,DF,Norwich City,29,1991,32.2,44,25,28,14,2,18,35,51.4,17,56,45,11,56,100,176,2
206,Jack Harrison,ENG,FW|MF,Leeds United,24,1996,29.3,57,37,22,22,13,31,76,40.8,45,35,1,34,21,78,19,0
207,Kortney Hause,ENG,DF,Aston Villa,26,1995,4.4,3,3,2,0,1,3,4,75.0,1,8,5,3,6,9,13,0
208,Kai Havertz,GER,FW|MF,Chelsea,22,1999,20.1,17,8,5,7,5,4,14,28.6,10,28,1,27,4,21,32,1
209,Isaac Hayden,ENG,MF|DF,Newcastle Utd,26,1995,11.1,28,14,11,14,3,12,29,41.4,17,17,8,9,14,42,24,0
210,Hwang Hee-chan,KOR,FW|MF,Wolves,25,1996,20.2,27,13,9,16,2,14,44,31.8,30,10,0,10,13,40,7,1
211,Jordan Henderson,ENG,MF,Liverpool,31,1990,28.9,36,20,9,25,2,17,44,38.6,27,25,1,24,23,59,14,0
212,Jeff Hendrick,IRL,MF,Newcastle Utd,29,1992,0.8,1,1,0,1,0,1,1,100.0,0,0,0,0,0,1,1,0
213,Wayne Hennessey,WAL,GK,Burnley,34,1987,2.0,0,0,0,0,0,0,0,,0,0,0,0,1,1,0,1
214,Rico Henry,ENG,DF,Brentford,24,1997,30.8,28,20,18,8,2,12,34,35.3,22,31,10,21,26,54,76,1
215,Son Heung-min,KOR,MF|FW,Tottenham,29,1992,33.4,15,6,5,7,3,5,23,21.7,18,27,6,21,13,28,8,0
216,Ki-Jana Hoever,NED,DF|MF,Wolves,19,2002,3.4,10,6,5,5,0,7,12,58.3,5,6,0,6,6,16,8,0
217,Rob Holding,ENG,DF,Arsenal,25,1995,9.4,13,9,11,1,1,5,6,83.3,1,23,18,5,10,23,42,1
218,Mason Holgate,ENG,DF,Everton,24,1996,23.7,35,18,26,9,0,11,26,42.3,15,25,17,8,26,61,95,1
219,Callum Hudson-Odoi,ENG,MF|FW,Chelsea,20,2000,10.7,14,10,5,6,3,8,23,34.8,15,8,0,8,2,16,6,1
220,Will Hughes,ENG,MF,Crystal Palace,26,1995,11.7,29,14,10,16,3,7,16,43.8,9,13,7,6,8,37,10,0
221,Pierre Højbjerg,DEN,MF,Tottenham,25,1995,35.5,78,45,31,38,9,38,85,44.7,47,61,13,48,48,126,54,0
222,Adam Idah,IRL,FW|MF,Norwich City,20,2001,6.9,9,6,2,5,2,2,3,66.7,1,4,2,2,3,12,7,0
223,Kelechi Iheanacho,NGA,FW,Leicester City,24,1996,14.0,10,7,2,5,3,3,14,21.4,11,19,0,19,4,14,10,0
224,Danny Ings,ENG,FW,Aston Villa,29,1992,21.1,23,16,2,16,5,13,37,35.1,24,31,2,29,6,29,22,0
225,Tim Iroegbunam,ENG,MF,Aston Villa,18,2003,1.0,5,4,2,3,0,1,1,100.0,0,0,0,0,2,7,1,0
226,Alex Iwobi,NGA,MF|DF,Everton,25,1996,22.6,40,19,23,12,5,21,52,40.4,31,39,3,36,20,60,25,2
227,Daniel James,WAL,FW,Manchester Utd,23,1997,1.4,2,1,0,2,0,0,0,,0,2,0,2,0,2,1,0
228,Daniel James,WAL,FW|MF,Leeds United,23,1997,26.3,24,14,8,8,8,10,23,43.5,13,18,1,17,8,32,12,0
229,Reece James,ENG,DF,Chelsea,21,1999,20.7,33,25,14,18,1,9,22,40.9,13,20,2,18,17,50,22,0
230,Vitaly Janelt,GER,MF,Brentford,23,1998,25.5,61,32,26,27,8,27,53,50.9,26,23,7,16,28,89,35,0
231,Pontus Jansson,SWE,DF,Brentford,30,1991,36.9,40,21,32,8,0,22,34,64.7,12,37,27,10,52,92,187,0
232,Mathias Jensen,DEN,MF,Brentford,25,1996,17.8,33,18,12,16,5,22,63,34.9,41,32,3,29,22,55,13,0
233,Gabriel Jesus,BRA,FW,Manchester City,24,1997,20.9,18,12,2,4,12,6,26,23.1,20,18,0,18,15,33,8,0
234,Raúl Jiménez,MEX,FW,Wolves,30,1991,29.2,29,14,6,16,7,6,30,20.0,24,31,5,26,13,42,26,0
235,João Pedro,BRA,FW|MF,Watford,19,2001,18.3,20,14,7,8,5,6,23,26.1,17,23,3,20,15,35,17,0
236,Joelinton,BRA,MF|FW,Newcastle Utd,24,1996,28.4,72,38,30,33,9,26,61,42.6,35,46,11,35,34,106,50,2
237,Ben Johnson,ENG,DF,West Ham,21,2000,15.5,33,16,15,15,3,21,28,75.0,7,16,8,8,22,55,55,0
238,Curtis Jones,ENG,MF,Liverpool,20,2001,9.5,11,9,3,6,2,1,10,10.0,9,4,0,4,6,17,4,0
239,Phil Jones,ENG,DF,Manchester Utd,29,1992,1.8,5,5,3,1,1,2,3,66.7,1,4,4,0,3,8,8,0
240,Jorginho,ITA,MF,Chelsea,29,1991,25.3,64,33,27,31,6,29,83,34.9,54,27,4,23,36,100,21,1
241,Diogo Jota,POR,FW,Liverpool,24,1996,26.3,39,18,12,18,9,13,55,23.6,42,19,2,17,6,45,6,0
242,James Justin,ENG,DF,Leicester City,23,1998,11.1,22,13,11,8,3,7,15,46.7,8,16,4,12,17,39,34,0
243,Mathias Jørgensen,DEN,DF,Brentford,31,1990,5.8,10,4,3,5,2,7,10,70.0,3,6,1,5,10,20,13,0
244,Ozan Kabak,TUR,DF,Norwich City,21,2000,10.2,10,5,4,6,0,5,9,55.6,4,19,11,8,16,26,26,0
245,Christian Kabasele,BEL,DF,Watford,30,1991,13.3,11,5,10,1,0,7,10,70.0,3,20,16,4,14,25,67,1
246,Samuel Kalu,NGA,FW,Watford,23,1997,2.5,2,2,0,2,0,1,1,100.0,0,2,0,2,3,5,3,0
247,Hassane Kamara,CIV,DF,Watford,27,1994,18.0,53,34,31,16,6,27,43,62.8,16,20,4,16,69,122,67,0
248,Harry Kane,ENG,FW,Tottenham,28,1993,35.9,15,5,2,10,3,7,18,38.9,11,26,8,18,3,18,39,0
249,N'Golo Kanté,FRA,MF,Chelsea,30,1991,19.7,59,31,20,27,12,25,40,62.5,15,37,2,35,31,90,8,0
250,Edo Kayembe,COD,MF,Watford,23,1998,8.9,21,13,11,9,1,8,16,50.0,8,6,1,5,9,30,13,0
251,Moise Kean,ITA,FW,Everton,21,2000,0.0,0,0,0,0,0,0,0,,0,0,0,0,0,0,0,0
252,Michael Keane,ENG,DF,Everton,28,1993,31.0,46,25,32,13,1,28,45,62.2,17,33,28,5,62,108,128,2
253,Naby Keïta,GUI,MF,Liverpool,26,1995,13.0,46,23,17,19,10,26,42,61.9,16,33,2,31,14,60,8,0
254,Caoimhín Kelleher,IRL,GK,Liverpool,22,1998,2.0,1,1,1,0,0,1,1,100.0,0,0,0,0,0,1,1,0
255,Kenedy,BRA,DF,Chelsea,25,1996,0.6,5,2,1,2,2,2,3,66.7,1,0,0,0,0,5,0,0
256,Jonjoe Kenny,ENG,DF,Everton,24,1997,11.3,17,7,11,6,0,13,21,61.9,8,8,1,7,20,37,31,0
257,Max Kilman,ENG,DF,Wolves,24,1997,29.9,50,26,38,10,2,24,37,64.9,13,36,21,15,45,95,113,3
258,Joshua King,NOR,FW,Watford,29,1992,25.0,19,15,7,6,6,4,17,23.5,13,15,4,11,8,27,31,0
259,Kristoffer Klaesson,NOR,GK,Leeds United,20,2000,0.4,0,0,0,0,0,0,0,,0,0,0,0,0,0,0,0
260,Mateusz Klich,POL,MF,Leeds United,31,1990,23.0,47,25,18,23,6,25,66,37.9,41,22,4,18,11,58,20,0
261,Robin Koch,GER,MF|DF,Leeds United,25,1996,17.5,21,13,9,10,2,9,34,26.5,25,26,10,16,20,41,44,0
262,Sead Kolašinac,BIH,DF,Arsenal,28,1993,1.0,0,0,0,0,0,0,0,,0,0,0,0,4,4,1,0
263,Ibrahima Konaté,FRA,DF,Liverpool,22,1999,11.0,16,10,9,6,1,7,10,70.0,3,13,9,4,16,32,37,1
264,Ezri Konsa,ENG,DF,Aston Villa,23,1997,27.5,25,15,13,11,1,10,13,76.9,3,31,22,9,15,40,86,2
265,Cheikhou Kouyaté,SEN,MF,Crystal Palace,31,1989,21.9,52,38,28,22,2,18,39,46.2,21,40,14,26,38,90,39,0
266,Mateo Kovačić,CRO,MF,Chelsea,27,1994,17.3,51,31,14,26,11,17,35,48.6,18,19,4,15,7,58,9,1
267,Emil Krafth,SWE,DF,Newcastle Utd,26,1994,18.2,37,16,25,11,1,27,36,75.0,9,16,10,6,25,62,56,0
268,Alex Král,CZE,MF,West Ham,23,1998,0.0,0,0,0,0,0,0,0,,0,0,0,0,0,0,0,0
269,Tim Krul,NED,GK,Norwich City,33,1988,29.0,1,1,1,0,0,1,4,25.0,3,0,0,0,0,1,10,4
270,Juraj Kucka,SVK,MF,Watford,34,1987,21.3,59,39,32,25,2,27,73,37.0,46,30,9,21,27,86,46,2
271,Dejan Kulusevski,SWE,MF|FW,Tottenham,21,2000,14.0,19,13,7,10,2,5,23,21.7,18,14,0,14,13,32,3,0
272,Alexandre Lacazette,FRA,FW,Arsenal,30,1991,19.8,27,10,8,13,6,7,21,33.3,14,12,1,11,5,32,6,0
273,Adam Lallana,ENG,MF,Brighton,33,1988,17.3,34,17,14,14,6,12,41,29.3,29,16,6,10,16,50,13,1
274,Tariq Lamptey,GHA,DF|FW,Brighton,20,2000,17.3,36,25,14,17,5,15,25,60.0,10,13,3,10,21,57,23,0
275,Manuel Lanzini,ARG,MF|FW,West Ham,28,1993,19.8,28,15,10,11,7,10,35,28.6,25,16,0,16,19,47,10,0
276,Aymeric Laporte,ESP,DF,Manchester City,27,1994,31.4,33,15,22,10,1,14,20,70.0,6,15,10,5,20,53,64,2
277,Jamaal Lascelles,ENG,DF,Newcastle Utd,27,1993,22.9,15,7,9,5,1,4,12,33.3,8,38,28,10,22,37,121,1
278,Pierre Lees-Melou,FRA,MF,Norwich City,28,1993,25.2,58,36,23,29,6,25,92,27.2,67,37,11,26,25,83,23,0
279,Aaron Lennon,ENG,MF|FW,Burnley,34,1987,17.2,33,17,10,13,10,10,34,29.4,24,26,4,22,9,42,14,0
280,Bernd Leno,GER,GK,Arsenal,29,1992,4.0,1,1,1,0,0,1,1,100.0,0,0,0,0,0,1,1,0
281,Jamal Lewis,NIR,DF,Newcastle Utd,23,1998,2.9,8,6,6,1,1,3,4,75.0,1,3,2,1,3,11,8,0
282,Victor Lindelöf,SWE,DF,Manchester Utd,27,1994,26.2,16,11,9,7,0,9,14,64.3,5,26,17,9,25,41,96,0
283,Jesse Lingard,ENG,FW|MF,Manchester Utd,28,1992,4.1,9,7,4,3,2,2,6,33.3,4,4,0,4,0,9,1,0
284,Valentino Livramento,ENG,DF,Southampton,18,2002,24.5,54,28,30,18,6,27,45,60.0,18,23,9,14,47,101,50,1
285,Diego Llorente,ESP,DF,Leeds United,27,1993,26.0,53,31,32,19,2,33,47,70.2,14,35,17,18,40,93,77,2
286,Hugo Lloris,FRA,GK,Tottenham,34,1986,38.0,1,1,1,0,0,1,2,50.0,1,0,0,0,1,2,24,3
287,Giovani Lo Celso,ARG,MF|FW,Tottenham,25,1996,2.6,8,4,4,2,2,4,10,40.0,6,6,1,5,1,9,0,1
288,Jürgen Locadia,NED,MF|FW,Brighton,27,1993,0.3,0,0,0,0,0,0,0,,0,0,0,0,0,0,0,0
289,Ruben Loftus-Cheek,ENG,MF|DF,Chelsea,25,1996,15.5,29,10,16,11,2,10,19,52.6,9,15,6,9,11,40,17,0
290,Kevin Long,IRL,DF,Burnley,30,1990,4.6,3,2,1,2,0,1,2,50.0,1,4,1,3,1,4,20,0
291,Shane Long,IRL,FW,Southampton,34,1987,3.4,9,5,2,4,3,1,1,100.0,0,4,0,4,0,9,2,0
292,Sean Longstaff,ENG,MF,Newcastle Utd,23,1997,16.3,54,34,18,31,5,24,65,36.9,41,18,6,12,9,63,18,0
293,Ademola Lookman,NGA,FW|MF,Leicester City,23,1997,16.1,32,14,10,13,9,10,28,35.7,18,19,1,18,10,42,4,0
294,Jonas Lössl,DEN,GK,Brentford,32,1989,2.0,0,0,0,0,0,0,0,,0,0,0,0,0,0,1,0
295,Imran Louza,MAR,MF,Watford,22,1999,15.7,41,21,18,20,3,16,38,42.1,22,28,6,22,42,83,20,1
296,Matthew Lowton,ENG,DF,Burnley,32,1989,19.7,38,24,20,10,8,20,37,54.1,17,25,11,14,26,64,68,0
297,Douglas Luiz,BRA,MF,Aston Villa,23,1998,30.2,59,39,30,24,5,21,72,29.2,51,30,7,23,34,93,28,1
298,Romelu Lukaku,BEL,FW,Chelsea,28,1993,17.7,2,1,0,1,1,1,5,20.0,4,11,1,10,0,2,20,0
299,Lyanco,BRA,DF,Southampton,24,1997,10.1,18,15,11,7,0,10,18,55.6,8,18,13,5,13,31,50,1
300,Alexis Mac Allister,ARG,MF|FW,Brighton,22,1998,23.6,65,40,23,30,12,29,68,42.6,39,37,7,30,13,78,22,0
301,James Maddison,ENG,MF|FW,Leicester City,24,1996,27.3,40,20,8,24,8,14,46,30.4,32,18,3,15,11,51,12,0
302,Harry Maguire,ENG,DF,Manchester Utd,28,1993,27.9,34,21,22,8,4,19,31,61.3,12,36,29,7,32,66,101,3
303,Riyad Mahrez,ALG,FW,Manchester City,30,1991,16.6,11,3,5,4,2,5,19,26.3,14,15,1,14,6,17,6,0
304,Ainsley Maitland-Niles,ENG,MF,Arsenal,23,1997,3.0,8,4,5,3,0,2,4,50.0,2,2,0,2,4,12,4,0
305,Sadio Mané,SEN,FW,Liverpool,29,1992,31.3,33,20,7,14,12,8,26,30.8,18,30,1,29,8,41,15,0
306,Javier Manquillo,ESP,DF,Newcastle Utd,27,1994,14.0,39,29,28,10,1,21,36,58.3,15,15,6,9,10,49,32,0
307,Fernando Marçal,BRA,MF|DF,Wolves,32,1989,16.1,42,22,27,14,1,21,37,56.8,16,25,4,21,28,70,52,0
308,Solly March,ENG,DF|FW,Brighton,27,1994,19.4,30,17,11,9,10,7,22,31.8,15,22,3,19,17,47,25,0
309,Pablo Marí,ESP,DF,Arsenal,27,1993,2.0,5,3,1,3,1,3,6,50.0,3,5,4,1,3,8,10,0
310,Anthony Martial,FRA,FW,Manchester Utd,25,1995,2.4,0,0,0,0,0,0,1,0.0,1,1,0,1,0,0,1,0
311,Gabriel Martinelli,BRA,FW|MF,Arsenal,20,2001,20.7,27,19,7,14,6,10,29,34.5,19,26,1,25,20,47,15,0
312,Emiliano Martínez,ARG,GK,Aston Villa,28,1992,36.0,1,1,1,0,0,1,3,33.3,2,0,0,0,0,1,6,1
313,Adam Masina,MAR,DF,Watford,27,1994,12.0,24,13,11,10,3,12,29,41.4,17,18,6,12,18,42,45,0
314,Arthur Masuaku,COD,DF|FW,West Ham,27,1993,7.2,31,23,19,11,1,14,23,60.9,9,9,1,8,9,40,17,0
315,Juan Mata,ESP,MF,Manchester Utd,33,1988,2.6,6,4,2,3,1,3,5,60.0,2,1,0,1,1,7,1,0
316,Jean-Philippe Mateta,FRA,FW,Crystal Palace,24,1997,12.7,8,4,2,5,1,3,18,16.7,15,11,3,8,4,12,13,0
317,Nemanja Matić,SRB,MF,Manchester Utd,32,1988,15.4,31,18,19,11,1,15,31,48.4,16,21,6,15,31,62,21,3
318,Joël Matip,CMR,DF,Liverpool,29,1991,31.0,47,34,23,19,5,20,31,64.5,11,26,14,12,44,91,93,1
319,Neal Maupay,FRA,FW,Brighton,24,1996,25.3,17,10,2,6,9,4,18,22.2,14,21,2,19,2,19,2,0
320,Bryan Mbeumo,CMR,FW,Brentford,21,1999,32.3,28,16,1,12,15,6,20,30.0,14,21,6,15,11,39,20,0
321,James McArthur,SCO,MF,Crystal Palace,33,1987,16.0,33,23,13,19,1,16,44,36.4,28,23,9,14,30,63,27,0
322,James Mcatee,ENG,MF|FW,Manchester City,18,2002,0.2,0,0,0,0,0,0,2,0.0,2,0,0,0,0,0,0,0
323,Kasey McAteer,ENG,FW,Leicester City,19,2001,0.0,0,0,0,0,0,0,0,,0,0,0,0,0,0,0,0
324,Liam McCarron,SCO,FW,Leeds United,20,2001,0.1,0,0,0,0,0,0,0,,0,1,0,1,0,0,0,0
325,Alex McCarthy,ENG,GK,Southampton,31,1989,17.0,0,0,0,0,0,0,0,,0,0,0,0,0,0,4,0
326,John McGinn,SCO,MF,Aston Villa,26,1994,34.3,106,64,35,55,16,54,104,51.9,50,53,6,47,35,141,34,0
327,Stuart McKinstry,SCO,MF,Leeds United,18,2002,0.0,0,0,0,0,0,0,0,,0,0,0,0,0,0,0,0
328,Kenny McLean,SCO,MF,Norwich City,29,1992,30.1,42,22,18,20,4,17,59,28.8,42,29,7,22,34,76,54,0
329,Dwight McNeil,ENG,MF,Burnley,21,1999,34.5,78,49,27,38,13,33,73,45.2,40,64,11,53,35,113,31,1
330,Scott McTominay,SCO,MF,Manchester Utd,24,1996,26.5,65,33,32,24,9,30,61,49.2,31,45,10,35,31,96,60,1
331,Ben Mee,ENG,DF,Burnley,31,1989,20.4,26,12,16,7,3,12,19,63.2,7,28,22,6,24,50,94,1
332,Hannibal Mejbri,TUN,FW,Manchester Utd,18,2003,0.8,2,1,1,1,0,1,1,100.0,0,0,0,0,0,2,0,0
333,Benjamin Mendy,FRA,DF,Manchester City,27,1994,0.9,2,2,1,1,0,2,6,33.3,4,0,0,0,0,2,0,0
334,Edouard Mendy,SEN,GK,Chelsea,29,1992,34.0,1,0,1,0,0,1,3,33.3,2,0,0,0,0,1,13,4
335,Nampalys Mendy,SEN,MF,Leicester City,29,1992,11.5,12,6,8,4,0,6,17,35.3,11,7,4,3,11,23,11,1
336,Illan Meslier,FRA,GK,Leeds United,21,2000,37.6,1,1,1,0,0,1,1,100.0,0,0,0,0,0,1,27,1
337,Luka Milivojević,SRB,MF,Crystal Palace,30,1991,8.6,18,9,9,6,3,10,16,62.5,6,6,1,5,11,29,15,0
338,James Milner,ENG,MF|DF,Liverpool,35,1986,9.5,28,16,12,11,5,12,29,41.4,17,19,5,14,17,45,20,0
339,Yerry Mina,COL,DF,Everton,26,1994,9.4,12,10,12,0,0,10,13,76.9,3,13,9,4,11,23,38,1
340,Takumi Minamino,JPN,FW|MF,Liverpool,26,1995,2.1,3,2,1,1,1,2,8,25.0,6,2,0,2,1,4,2,0
341,Tyrone Mings,ENG,DF,Aston Villa,28,1993,35.4,23,12,17,3,3,14,22,63.6,8,47,30,17,46,69,153,2
342,Tyrick Mitchell,ENG,DF,Crystal Palace,21,1999,34.5,104,57,67,26,11,46,67,68.7,21,47,5,42,41,145,101,0
343,Jakub Moder,POL,MF,Brighton,22,1999,18.9,42,25,18,17,7,23,42,54.8,19,25,2,23,10,52,22,1
344,Wesley Moraes,BRA,FW,Aston Villa,24,1996,0.0,0,0,0,0,0,0,0,,0,0,0,0,0,0,0,0
345,Tyler Morton,ENG,MF,Liverpool,18,2002,0.7,0,0,0,0,0,0,2,0.0,2,0,0,0,3,3,0,0
346,Mason Mount,ENG,MF,Chelsea,22,1999,26.3,41,16,10,17,14,10,34,29.4,24,18,1,17,13,54,12,0
347,Lucas Moura,BRA,FW|MF,Tottenham,28,1992,19.7,25,10,7,14,4,8,35,22.9,27,19,0,19,18,43,19,0
348,João Moutinho,POR,MF,Wolves,34,1986,33.0,74,39,34,27,13,30,106,28.3,76,48,8,40,34,108,36,2
349,Bali Mumba,ENG,DF,Norwich City,19,2001,0.5,1,1,1,0,0,0,0,,0,0,0,0,0,1,5,0
350,Jacob Murphy,ENG,FW|DF,Newcastle Utd,26,1995,16.4,49,26,34,11,4,26,41,63.4,15,20,2,18,23,72,17,0
351,Enock Mwepu,ZAM,MF,Brighton,23,1998,11.1,22,12,10,10,2,5,27,18.5,22,20,2,18,12,34,19,0
352,Vitaliy Mykolenko,UKR,DF,Everton,22,1999,11.7,25,15,15,7,3,12,21,57.1,9,15,2,13,16,41,37,0
353,Marvelous Nakamba,ZIM,MF,Aston Villa,27,1994,10.0,32,19,18,14,0,12,34,35.3,22,14,4,10,12,44,17,1
354,Wilfred Ndidi,NGA,MF|DF,Leicester City,24,1996,18.0,60,32,32,27,1,22,55,40.0,33,36,8,28,42,102,54,1
355,Tanguy Ndombele,FRA,MF,Tottenham,24,1996,5.4,10,7,3,5,2,1,8,12.5,7,5,0,5,1,11,1,0
356,Reiss Nelson,ENG,FW,Arsenal,21,1999,0.2,1,0,0,0,1,0,1,0.0,1,1,0,1,0,1,0,0
357,Pedro Neto,POR,FW|MF,Wolves,21,2000,5.2,4,4,2,0,2,0,9,0.0,9,0,0,0,6,10,1,0
358,Rúben Neves,POR,MF,Wolves,24,1997,29.6,68,37,23,41,4,24,87,27.6,63,39,5,34,41,109,49,3
359,Jeremy Ngakia,ENG,DF,Watford,20,2000,10.0,31,18,23,5,3,11,26,42.3,15,11,4,7,12,43,32,0
360,Saúl Ñíguez,ESP,DF|MF,Chelsea,26,1994,5.3,20,9,11,9,0,9,16,56.3,7,14,3,11,7,27,10,1
361,Eddie Nketiah,ENG,FW,Arsenal,22,1999,9.3,9,4,1,4,4,1,4,25.0,3,9,2,7,4,13,5,0
362,Nicolas Nkoulou,CMR,DF,Watford,31,1990,1.9,1,0,0,1,0,0,0,,0,2,1,1,2,3,8,0
363,Mark Noble,ENG,MF,West Ham,34,1987,3.7,8,2,7,1,0,5,11,45.5,6,4,1,3,4,12,2,1
364,Mathias Normann,NOR,MF,Norwich City,25,1996,18.3,34,21,19,14,1,17,46,37.0,29,17,8,9,19,53,43,1
365,Christian Nørgaard,DEN,MF,Brentford,27,1994,33.9,109,60,42,58,9,52,101,51.5,49,48,9,39,64,173,58,1
366,Angelo Ogbonna,ITA,DF,West Ham,33,1988,10.2,7,4,5,2,0,3,7,42.9,4,5,4,1,11,18,29,0
367,Michael Olise,FRA,FW|MF,Crystal Palace,19,2001,12.7,22,18,8,11,3,7,24,29.2,17,17,0,17,6,28,6,0
368,Robin Olsen,SWE,GK,Aston Villa,31,1990,1.0,0,0,0,0,0,0,0,,0,0,0,0,0,0,0,0
369,Andrew Omobamidele,IRL,DF,Norwich City,19,2002,4.2,8,6,5,3,0,5,11,45.5,6,8,8,0,5,13,13,0
370,Tyler Onyango,ENG,MF,Everton,18,2003,0.3,0,0,0,0,0,0,0,,0,0,0,0,0,0,1,0
371,Frank Onyeka,NGA,MF,Brentford,23,1998,11.6,25,17,13,9,3,8,27,29.6,19,16,2,14,14,39,13,0
372,Divock Origi,BEL,FW,Liverpool,26,1995,1.5,0,0,0,0,0,0,2,0.0,2,1,0,1,1,1,2,0
373,Alex Oxlade-Chamberlain,ENG,MF|FW,Liverpool,27,1993,8.7,15,11,2,8,5,3,14,21.4,11,12,2,10,6,21,5,0
374,Cole Palmer,ENG,FW|MF,Manchester City,19,2002,1.4,2,1,1,1,0,0,2,0.0,2,3,0,3,1,3,0,0
375,Emerson Palmieri,ITA,DF,Chelsea,26,1994,0.1,0,0,0,0,0,0,0,,0,0,0,0,0,0,0,0
376,Thomas Partey,GHA,MF,Arsenal,28,1993,22.5,43,29,22,17,4,18,44,40.9,26,22,4,18,23,66,35,2
377,Nicolas Pépé,CIV,FW|MF,Arsenal,26,1995,7.7,8,5,3,5,0,3,9,33.3,6,9,1,8,8,16,2,0
378,Ricardo Pereira,POR,DF,Leicester City,27,1993,11.0,37,20,19,13,5,21,40,52.5,19,13,1,12,17,54,39,0
379,Ayoze Pérez,ESP,MF|FW,Leicester City,28,1993,4.9,4,2,0,3,1,0,13,0.0,13,11,1,10,2,6,5,0
380,Sonny Perkins,ENG,MF,West Ham,17,2004,0.0,0,0,0,0,0,0,0,,0,0,0,0,0,0,0,0
381,Romain Perraud,FRA,DF,Southampton,23,1997,18.0,34,22,18,14,2,16,29,55.2,13,24,6,18,17,51,42,0
382,Kalvin Phillips,ENG,MF,Leeds United,25,1995,17.7,54,25,24,25,5,24,57,42.1,33,37,9,28,24,78,18,0
383,Jaden Philogene Bidace,ENG,FW,Aston Villa,19,2002,0.1,0,0,0,0,0,0,0,,0,0,0,0,0,0,0,0
384,Jordan Pickford,ENG,GK,Everton,27,1994,35.0,1,1,1,0,0,0,1,0.0,1,1,0,1,1,2,14,1
385,Erik Pieters,NED,DF,Burnley,32,1988,8.1,28,15,15,11,2,17,28,60.7,11,18,7,11,10,38,38,0
386,Ethan Pinnock,JAM,DF,Brentford,28,1993,29.9,51,35,37,12,2,25,38,65.8,13,30,11,19,44,95,154,1
387,Daniel Podence,POR,FW|MF,Wolves,25,1995,16.5,18,11,10,5,3,4,17,23.5,13,8,1,7,10,28,1,0
388,Paul Pogba,FRA,MF|FW,Manchester Utd,28,1993,15.0,13,9,5,7,1,6,28,21.4,22,11,0,11,13,26,16,0
389,Nick Pope,ENG,GK,Burnley,29,1992,36.0,0,0,0,0,0,0,2,0.0,2,0,0,0,2,2,30,3
390,Isaac Price,NIR,MF,Everton,17,2003,0.2,0,0,0,0,0,0,0,,0,1,0,1,0,0,0,0
391,Teemu Pukki,FIN,FW,Norwich City,31,1990,36.1,23,11,2,14,7,6,29,20.7,23,21,1,20,4,27,3,0
392,Christian Pulisic,USA,MF|FW,Chelsea,22,1998,14.3,10,7,6,3,1,3,17,17.6,14,12,0,12,5,15,10,0
393,Przemysław Płacheta,POL,FW|MF,Norwich City,23,1998,5.6,4,3,3,1,0,2,7,28.6,5,3,1,2,2,6,5,1
394,Jesuran Rak Sakyi,ENG,FW|MF,Crystal Palace,18,2002,0.9,0,0,0,0,0,0,1,0.0,1,3,0,3,1,1,0,0
395,Aaron Ramsdale,ENG,GK,Arsenal,23,1998,34.0,2,1,2,0,0,1,2,50.0,1,0,0,0,0,2,26,3
396,Jacob Ramsey,ENG,MF,Aston Villa,20,2001,27.4,67,44,31,28,8,30,69,43.5,39,36,7,29,24,91,28,0
397,Raphinha,BRA,FW|MF,Leeds United,24,1996,32.4,51,29,25,14,12,22,71,31.0,49,43,0,43,29,80,28,1
398,Marcus Rashford,ENG,FW|MF,Manchester Utd,23,1997,13.7,6,5,1,4,1,2,13,15.4,11,10,1,9,5,11,5,1
399,Milot Rashica,KVX,FW|MF,Norwich City,25,1996,24.8,31,19,12,12,7,11,30,36.7,19,22,3,19,15,46,23,0
400,David Raya,ESP,GK,Brentford,25,1995,24.0,0,0,0,0,0,0,0,,0,1,0,1,0,0,10,1
401,Nathan Redmond,ENG,MF|FW,Southampton,27,1994,20.4,22,14,9,9,4,7,30,23.3,23,21,2,19,8,30,16,0
402,Sergio Reguilón,ESP,DF|MF,Tottenham,24,1996,21.3,40,24,15,18,7,22,43,51.2,21,20,8,12,31,71,45,1
403,Declan Rice,ENG,MF,West Ham,22,1999,35.3,80,42,45,32,3,38,71,53.5,33,45,21,24,63,143,52,1
404,Taylor Richards,ENG,MF,Brighton,20,2000,0.3,1,0,0,1,0,1,2,50.0,1,0,0,0,0,1,0,0
405,Richarlison,BRA,FW,Everton,24,1997,28.0,40,23,18,15,7,15,31,48.4,16,42,4,38,12,52,34,0
406,Jaïro Riedewald,NED,MF,Crystal Palace,24,1996,1.3,1,1,0,1,0,1,2,50.0,1,1,0,1,1,2,2,0
407,Matt Ritchie,SCO,DF,Newcastle Utd,31,1989,14.9,22,15,10,10,2,10,27,37.0,17,10,2,8,13,35,26,0
408,Connor Roberts,WAL,DF,Burnley,25,1995,18.8,20,13,10,7,3,10,15,66.7,5,25,5,20,22,42,62,1
409,Tyler Roberts,WAL,MF|FW,Leeds United,22,1999,11.0,16,7,6,7,3,9,16,56.3,7,11,1,10,5,21,11,0
410,Andrew Robertson,SCO,DF,Liverpool,27,1994,28.2,36,21,16,15,5,20,35,57.1,15,24,3,21,23,59,61,0
411,Joe Rodon,WAL,DF,Tottenham,23,1997,1.0,0,0,0,0,0,0,0,,0,2,1,1,0,0,7,0
412,Rodri,ESP,MF,Manchester City,25,1996,32.0,72,43,24,38,10,32,59,54.2,27,28,5,23,28,100,45,0
413,Rodrigo,ESP,MF|FW,Leeds United,30,1991,25.2,20,9,7,6,7,4,32,12.5,28,12,0,12,11,31,27,1
414,Jay Rodriguez,ENG,FW,Burnley,32,1989,15.4,20,12,8,8,4,4,14,28.6,10,19,1,18,4,24,12,0
415,Mads Roerslev,DEN,DF,Brentford,22,1999,13.8,23,12,19,2,2,14,32,43.8,18,14,5,9,16,39,29,0
416,Cristian Romero,ARG,DF,Tottenham,23,1998,20.5,62,39,39,21,2,22,34,64.7,12,46,21,25,33,95,74,1
417,Oriol Romeu,ESP,MF,Southampton,29,1991,32.1,77,39,25,45,7,28,73,38.4,45,39,8,31,51,128,43,0
418,Cristiano Ronaldo,POR,FW,Manchester Utd,36,1985,27.3,8,6,1,5,2,2,6,33.3,4,8,0,8,2,10,29,0
419,Salomón Rondón,VEN,FW,Everton,31,1989,8.8,6,1,1,2,3,4,14,28.6,10,5,0,5,0,6,10,0
420,Danny Rose,ENG,DF,Watford,31,1990,7.7,16,10,11,4,1,10,24,41.7,14,8,5,3,14,30,11,1
421,Jon Rowe,ENG,FW|MF,Norwich City,18,2003,2.5,3,2,2,1,0,2,3,66.7,1,7,0,7,3,6,1,0
422,John Ruddy,ENG,GK,Wolves,34,1986,1.5,0,0,0,0,0,0,0,,0,0,0,0,0,0,3,0
423,Antonio Rüdiger,GER,DF,Chelsea,28,1993,33.7,48,28,29,15,4,36,48,75.0,12,20,11,9,28,76,91,1
424,Lukas Rupp,GER,MF,Norwich City,30,1991,8.5,9,4,5,3,1,4,15,26.7,11,11,1,10,9,18,7,0
425,José Sá,POR,GK,Wolves,28,1993,36.5,2,1,2,0,0,2,4,50.0,2,0,0,0,2,4,19,5
426,Allan Saint-Maximin,FRA,FW|MF,Newcastle Utd,24,1997,31.2,13,8,6,4,3,3,17,17.6,14,13,2,11,11,24,3,0
427,Romain Saïss,MAR,DF,Wolves,31,1990,30.1,40,27,28,11,1,19,33,57.6,14,41,21,20,58,98,158,2
428,Bukayo Saka,ENG,FW|MF,Arsenal,19,2001,33.1,40,21,12,17,11,13,39,33.3,26,28,2,26,22,62,23,0
429,Mohamed Salah,EGY,FW,Liverpool,29,1992,30.7,17,8,5,9,3,6,19,31.6,13,7,1,6,6,23,5,0
430,Mohammed Salisu,GHA,DF,Southampton,22,1999,33.0,80,47,54,22,4,40,65,61.5,25,49,26,23,78,158,158,4
431,Albert Sambi Lokonga,BEL,MF,Arsenal,21,1999,12.6,22,18,11,9,2,12,14,85.7,2,12,7,5,13,35,12,4
432,Davinson Sánchez,COL,DF,Tottenham,25,1996,18.1,41,22,25,14,2,19,28,67.9,9,24,16,8,30,71,54,3
433,Robert Sánchez,ESP,GK,Brighton,23,1997,37.0,2,1,2,0,0,1,1,100.0,0,1,0,1,0,2,11,4
434,Jadon Sancho,ENG,FW|MF,Manchester Utd,21,2000,21.1,14,8,9,4,1,8,22,36.4,14,19,0,19,15,29,5,3
435,Morgan Sanson,FRA,MF,Aston Villa,26,1994,4.0,12,8,7,2,3,3,7,42.9,4,13,0,13,10,22,2,1
436,Samir Santos,BRA,DF,Watford,26,1994,18.6,24,11,18,6,0,8,19,42.1,11,21,11,10,43,67,85,3
437,Josh Sargent,USA,FW|MF,Norwich City,21,2000,17.5,26,14,15,7,4,14,39,35.9,25,29,2,27,11,37,18,2
438,Jeremy Sarmiento,ECU,FW|MF,Brighton,19,2002,0.5,1,1,0,0,1,0,2,0.0,2,2,0,2,0,1,0,0
439,Ismaila Sarr,SEN,FW|MF,Watford,23,1998,20.7,12,7,4,3,5,5,19,26.3,14,10,1,9,9,21,10,0
440,Malang Sarr,FRA,DF,Chelsea,22,1999,6.1,14,7,10,2,2,7,12,58.3,5,6,3,3,11,25,20,0
441,Dane Scarlett,ENG,MF,Tottenham,17,2004,0.0,0,0,0,0,0,0,0,,0,0,0,0,0,0,0,0
442,Fabian Schär,SUI,DF,Newcastle Utd,29,1991,24.0,16,11,11,3,2,8,16,50.0,8,27,18,9,32,48,95,2
443,Jeffrey Schlupp,GHA,MF|FW,Crystal Palace,28,1992,20.6,46,25,16,23,7,24,50,48.0,26,39,9,30,18,64,32,0
444,Kasper Schmeichel,DEN,GK,Leicester City,34,1986,37.0,0,0,0,0,0,0,2,0.0,2,0,0,0,1,1,15,2
445,Ken Sema,SWE,MF|FW,Watford,27,1993,9.5,16,6,11,4,1,9,20,45.0,11,10,0,10,5,21,11,0
446,Nélson Semedo,POR,MF|DF,Wolves,27,1993,23.7,58,39,39,17,2,25,49,51.0,24,23,4,19,21,79,64,1
447,Ryan Sessegnon,ENG,DF|MF,Tottenham,21,2000,11.6,25,19,14,7,4,11,22,50.0,11,18,3,15,7,32,26,0
448,Jamie Shackleton,ENG,DF|MF,Leeds United,21,1999,7.9,27,16,19,7,1,13,25,52.0,12,11,7,4,8,35,12,1
449,Luke Shaw,ENG,DF,Manchester Utd,26,1995,17.8,21,13,9,9,3,12,21,57.1,9,22,11,11,9,30,22,2
450,Jonjo Shelvey,ENG,MF,Newcastle Utd,29,1992,22.0,30,17,12,18,0,14,34,41.2,20,22,7,15,22,52,20,2
451,Shola Shoretire,ENG,MF,Manchester Utd,17,2004,0.2,0,0,0,0,0,0,0,,0,0,0,0,0,0,0,0
452,Francisco Sierralta,CHI,DF,Watford,24,1997,4.7,7,3,7,0,0,5,8,62.5,3,7,2,5,6,13,35,0
453,Bernardo Silva,POR,MF|FW,Manchester City,26,1994,31.7,57,29,19,19,19,31,67,46.3,36,24,2,22,20,77,19,0
454,Fábio Silva,POR,FW,Wolves,19,2002,6.4,3,2,0,2,1,0,8,0.0,8,2,0,2,1,4,1,0
455,Thiago Silva,BRA,DF,Chelsea,36,1984,29.4,32,21,19,12,1,11,22,50.0,11,54,31,23,44,76,100,0
456,Ellis Simms,ENG,FW,Everton,20,2001,0.7,0,0,0,0,0,0,0,,0,1,1,0,0,0,1,0
457,Moussa Sissoko,FRA,MF,Watford,31,1989,35.8,53,27,27,20,6,28,42,66.7,14,42,13,29,30,83,64,0
458,Oliver Skipp,ENG,MF,Tottenham,20,2000,15.0,33,19,14,18,1,15,31,48.4,16,19,7,12,12,45,10,1
459,William Smallbone,IRL,MF|FW,Southampton,21,2000,1.5,4,4,2,2,0,1,3,33.3,2,4,0,4,2,6,0,0
460,Emile Smith Rowe,ENG,MF|FW,Arsenal,21,2000,21.3,14,7,7,7,0,4,20,20.0,16,18,1,17,15,29,10,1
461,Cédric Soares,POR,DF,Arsenal,29,1991,16.5,38,26,23,9,6,16,25,64.0,9,18,7,11,16,54,31,1
462,Tomáš Souček,CZE,MF,West Ham,26,1995,34.0,66,32,27,33,6,28,65,43.1,37,34,13,21,52,118,98,1
463,Boubakary Soumaré,FRA,MF,Leicester City,22,1999,12.2,19,13,10,8,1,8,17,47.1,9,13,1,12,14,33,18,0
464,Çağlar Söyüncü,TUR,DF,Leicester City,25,1996,27.7,47,30,32,12,3,26,42,61.9,16,44,27,17,32,79,115,1
465,Tony Springett,IRL,MF|FW,Norwich City,18,2002,1.6,2,1,1,1,0,1,4,25.0,3,0,0,0,0,2,2,0
466,Jason Steele,ENG,GK,Brighton,30,1990,1.0,0,0,0,0,0,0,0,,0,0,0,0,0,0,0,0
467,Jed Steer,ENG,GK,Aston Villa,28,1992,1.0,0,0,0,0,0,0,0,,0,0,0,0,0,0,0,0
468,Zack Steffen,USA,GK,Manchester City,26,1995,1.0,0,0,0,0,0,0,0,,0,0,0,0,0,0,2,0
469,Dale Stephens,ENG,MF,Burnley,32,1989,1.4,4,1,0,3,1,3,8,37.5,5,4,1,3,1,5,1,0
470,Jack Stephens,ENG,DF,Southampton,27,1994,9.0,19,12,13,5,1,6,16,37.5,10,12,7,5,19,38,42,0
471,Raheem Sterling,ENG,FW,Manchester City,26,1994,23.6,23,10,3,11,9,10,23,43.5,13,12,0,12,12,35,3,0
472,Finley Stevens,WAL,DF,Brentford,18,2003,0.2,3,1,0,3,0,1,1,100.0,0,0,0,0,0,3,0,0
473,John Stones,ENG,DF,Manchester City,27,1994,12.4,5,3,3,2,0,2,3,66.7,1,3,3,0,11,16,27,1
474,Pascal Struijk,NED,DF|MF,Leeds United,21,1999,22.8,61,39,34,23,4,30,50,60.0,20,35,23,12,33,94,60,2
475,Crysencio Summerville,NED,MF|FW,Leeds United,19,2001,1.4,5,3,1,1,3,2,3,66.7,1,2,0,2,2,7,0,0
476,Jakob Sørensen,DEN,MF|DF,Norwich City,23,1998,6.7,22,11,6,14,2,10,20,50.0,10,7,3,4,10,32,19,0
477,Japhet Tanganga,ENG,DF,Tottenham,22,1999,8.2,14,8,7,6,1,9,19,47.4,10,13,5,8,9,23,31,0
478,Matt Targett,ENG,DF,Aston Villa,25,1995,15.9,34,18,28,5,1,24,45,53.3,21,16,9,7,23,57,35,0
479,Matt Targett,ENG,DF,Newcastle Utd,25,1995,16.0,41,26,26,14,1,24,37,64.9,13,15,4,11,25,66,39,1
480,James Tarkowski,ENG,DF,Burnley,28,1992,34.5,65,45,47,17,1,33,47,70.2,14,75,61,14,48,113,186,4
481,Nuno Tavares,POR,DF,Arsenal,21,2000,13.1,21,14,10,7,4,8,18,44.4,10,15,5,10,9,30,33,1
482,Charlie Taylor,ENG,DF,Burnley,27,1993,30.3,45,26,31,11,3,26,44,59.1,18,42,20,22,58,103,95,2
483,Nathan Tella,NGA,MF|FW,Southampton,22,1999,8.9,13,9,5,7,1,6,17,35.3,11,13,0,13,6,19,9,0
484,Alex Telles,BRA,DF,Manchester Utd,28,1992,18.4,48,27,35,9,4,27,43,62.8,16,17,4,13,26,74,45,0
485,Luke Thomas,ENG,DF,Leicester City,20,2001,21.2,50,31,33,13,4,28,65,43.1,37,35,14,21,40,90,55,0
486,Dominic Thompson,ENG,DF,Brentford,21,2000,1.6,1,0,1,0,0,0,1,0.0,1,2,2,0,2,3,3,0
487,Youri Tielemans,BEL,MF,Leicester City,24,1997,29.2,74,38,23,45,6,42,100,42.0,58,47,13,34,21,95,41,3
488,Kieran Tierney,SCO,DF,Arsenal,24,1997,21.3,18,14,11,7,0,10,11,90.9,1,23,5,18,15,33,54,0
489,Takehiro Tomiyasu,JPN,DF,Arsenal,22,1998,18.7,35,17,19,13,3,21,32,65.6,11,22,3,19,24,59,64,2
490,James Tomkins,ENG,DF,Crystal Palace,32,1989,6.1,8,3,6,2,0,6,8,75.0,2,8,8,0,4,12,18,0
491,Ivan Toney,ENG,FW,Brentford,25,1996,32.3,33,21,5,20,8,12,38,31.6,26,16,2,14,14,47,44,1
492,Ferrán Torres,ESP,FW,Manchester City,21,2000,3.4,2,2,0,1,1,0,3,0.0,3,2,0,2,0,2,1,0
493,Cenk Tosun,TUR,MF,Everton,30,1991,0.1,0,0,0,0,0,0,0,,0,0,0,0,0,0,0,0
494,Andros Townsend,ENG,MF|FW,Everton,30,1991,16.2,31,17,15,6,10,15,40,37.5,25,28,2,26,14,45,6,1
495,Adama Traoré,ESP,FW|MF,Wolves,25,1996,11.9,8,3,6,0,2,3,7,42.9,4,4,1,3,2,10,1,0
496,Bertrand Traoré,BFA,MF|FW,Aston Villa,25,1995,2.4,3,3,0,1,2,1,2,50.0,1,0,0,0,0,3,1,0
497,Trézéguet,EGY,FW,Aston Villa,26,1994,0.1,0,0,0,0,0,0,0,,0,0,0,0,0,0,0,0
498,Francisco Trincão,POR,FW|MF,Wolves,21,1999,14.8,28,15,9,13,6,3,19,15.8,16,17,1,16,12,40,1,1
499,Kieran Trippier,ENG,DF,Newcastle Utd,30,1990,4.8,17,10,8,8,1,10,16,62.5,6,10,3,7,10,27,10,0
500,William Troost-Ekong,NGA,DF,Watford,27,1993,15.4,18,9,11,6,1,10,15,66.7,5,24,14,10,7,25,82,1
501,Leandro Trossard,BEL,FW|MF,Brighton,26,1994,31.2,34,20,12,9,13,4,31,12.9,27,33,4,29,15,49,10,0
502,Kostas Tsimikas,GRE,DF,Liverpool,25,1996,9.7,27,12,12,8,7,12,16,75.0,4,6,2,4,10,37,22,2
503,Axel Tuanzebe,ENG,DF,Aston Villa,23,1997,5.6,5,3,3,2,0,2,5,40.0,3,5,4,1,5,10,12,1
504,Ozan Tufan,TUR,MF,Watford,26,1995,3.7,3,2,1,1,1,1,5,20.0,4,2,0,2,2,5,4,0
505,Christos Tzolis,GRE,FW|MF,Norwich City,19,2002,3.7,5,3,3,1,1,2,9,22.2,7,3,0,3,1,6,1,0
506,Yan Valery,TUN,DF,Southampton,22,1999,4.1,8,6,4,3,1,4,9,44.4,5,6,3,3,6,14,19,1
507,Virgil van Dijk,NED,DF,Liverpool,30,1991,34.0,16,10,11,5,0,11,16,68.8,5,21,14,7,31,47,109,0
508,Raphaël Varane,FRA,DF,Manchester Utd,28,1993,20.3,28,19,21,6,1,10,22,45.5,12,18,9,9,18,46,82,1
509,Jamie Vardy,ENG,FW,Leicester City,34,1987,20.1,6,5,0,4,2,1,7,14.3,6,9,0,9,1,7,17,0
510,Joël Veltman,NED,DF,Brighton,29,1992,31.9,74,48,47,21,6,21,53,39.6,32,46,16,30,45,119,89,0
511,Jannik Vestergaard,DEN,DF,Leicester City,28,1992,6.3,15,10,12,3,0,8,15,53.3,7,10,8,2,7,22,36,0
512,Nikola Vlašić,CRO,FW|MF,West Ham,23,1997,6.2,11,7,4,6,1,5,20,25.0,15,4,0,4,2,13,1,0
513,Matěj Vydra,CZE,FW,Burnley,29,1992,7.5,12,7,3,4,5,3,7,42.9,4,5,1,4,0,12,9,0
514,Theo Walcott,ENG,MF|FW,Southampton,32,1989,4.2,4,2,2,0,2,1,5,20.0,4,3,0,3,5,9,2,0
515,Kyle Walker,ENG,DF,Manchester City,31,1990,19.5,15,6,7,7,1,8,17,47.1,9,14,4,10,14,29,16,1
516,Kyle Walker-Peters,ENG,DF,Southampton,24,1997,29.3,57,33,28,21,8,26,38,68.4,12,29,8,21,37,94,53,1
517,Aaron Wan-Bissaka,ENG,DF,Manchester Utd,23,1997,19.9,49,36,25,18,6,14,20,70.0,6,24,14,10,34,83,41,2
518,Danny Ward,WAL,GK,Leicester City,28,1993,1.0,0,0,0,0,0,0,0,,0,0,0,0,0,0,1,0
519,Joel Ward,ENG,DF,Crystal Palace,31,1989,27.6,44,26,30,11,3,30,57,52.6,27,24,11,13,32,76,107,1
520,James Ward-Prowse,ENG,MF,Southampton,26,1994,35.7,41,24,12,24,5,19,70,27.1,51,43,15,28,40,81,45,1
521,Ollie Watkins,ENG,FW,Aston Villa,25,1995,32.8,17,13,2,7,8,2,15,13.3,13,25,3,22,12,29,27,0
522,Adam Webster,ENG,DF,Brighton,26,1995,15.9,26,8,17,7,2,13,20,65.0,7,25,17,8,17,43,66,2
523,Wout Weghorst,NED,FW,Burnley,28,1992,16.1,17,9,3,9,5,6,19,31.6,13,16,5,11,6,23,13,0
524,Danny Welbeck,ENG,FW|MF,Brighton,30,1990,16.4,14,7,2,8,4,3,10,30.0,7,18,2,16,5,19,18,0
525,Timo Werner,GER,FW|MF,Chelsea,25,1996,14.3,8,4,3,3,2,2,20,10.0,18,9,0,9,2,10,4,0
526,Ashley Westwood,ENG,MF,Burnley,31,1990,25.4,21,12,8,12,1,10,31,32.3,21,21,9,12,30,51,16,1
527,Ben White,ENG,DF,Arsenal,23,1997,32.0,44,23,30,8,6,28,45,62.2,17,42,24,18,42,86,102,0
528,Brandon Williams,ENG,DF,Norwich City,20,2000,23.6,55,37,35,18,2,36,64,56.3,28,26,6,20,44,99,50,0
529,Neco Williams,WAL,DF,Liverpool,20,2001,0.1,0,0,0,0,0,0,0,,0,0,0,0,0,0,0,0
530,Joe Willock,ENG,MF,Newcastle Utd,21,1999,22.6,64,37,30,28,6,29,68,42.6,39,37,6,31,21,85,10,1
531,Callum Wilson,ENG,FW,Newcastle Utd,29,1992,15.4,9,8,1,5,3,1,4,25.0,3,7,2,5,3,12,10,0
532,Harry Winks,ENG,MF,Tottenham,25,1996,10.1,15,10,4,9,2,8,21,38.1,13,14,3,11,16,31,10,2
533,Yoane Wissa,COD,FW,Brentford,24,1996,14.3,12,6,5,4,3,1,16,6.3,15,12,5,7,8,20,6,0
534,Chris Wood,NZL,FW,Burnley,29,1991,15.2,7,5,0,3,4,3,10,30.0,7,13,4,9,0,7,3,0
535,Chris Wood,NZL,FW,Newcastle Utd,29,1991,14.7,2,0,1,1,0,1,2,50.0,1,5,2,3,2,4,9,0
536,Freddie Woodman,ENG,GK,Newcastle Utd,24,1997,4.0,0,0,0,0,0,0,0,,0,0,0,0,0,0,0,1
537,Granit Xhaka,SUI,MF|DF,Arsenal,28,1992,25.9,32,18,16,12,4,16,41,39.0,25,21,6,15,21,53,31,0
538,Andriy Yarmolenko,UKR,FW|MF,West Ham,31,1989,3.5,4,2,2,2,0,2,8,25.0,6,4,2,2,0,4,2,0
539,Ashley Young,ENG,DF|FW,Aston Villa,36,1985,13.9,18,6,9,6,3,11,16,68.8,5,10,4,6,13,31,25,1
540,Nathan Young-Coombes,ENG,MF,Brentford,18,2003,0.0,0,0,0,0,0,0,0,,0,0,0,0,0,0,0,0
541,Wilfried Zaha,CIV,FW,Crystal Palace,28,1992,30.7,40,20,14,15,11,10,31,32.3,21,28,0,28,5,45,5,0
542,Christoph Zimmermann,GER,DF,Norwich City,28,1993,1.7,6,3,5,1,0,3,4,75.0,1,0,0,0,1,7,4,0
543,Oleksandr Zinchenko,UKR,DF,Manchester City,24,1996,11.6,20,14,7,10,3,11,20,55.0,9,11,3,8,14,34,15,1
544,Hakim Ziyech,MAR,MF|FW,Chelsea,28,1993,14.7,19,10,5,12,2,10,36,27.8,26,11,1,10,10,29,10,0
545,Kurt Zouma,FRA,DF,West Ham,26,1994,23.1,11,6,8,3,0,4,7,57.1,3,31,26,5,34,45,132,0
546,Martin Ødegaard,NOR,MF|FW,Arsenal,22,1998,30.9,49,21,6,24,19,22,61,36.1,39,18,1,17,11,60,11,1
